2010-12-01,0,com,8477125,1529482,6947643
2010-12-01,1,com,7980129,714185,7265944
2010-12-01,2,com,7487758,6502010,985748
2010-12-01,3,com,2485731,1035994,1449737
2010-12-01,4,com,1562279,5439148,-3876869
2010-12-01,5,com,8784933,7666654,1118279
2010-12-01,6,com,5639745,5081609,558136
2010-12-01,7,com,1441370,1303901,137469
2010-12-01,8,com,1542535,407772,1134763
2010-12-01,9,com,8877697,2811360,6066337
2010-12-01,10,com,854386,2672727,-1818341
2010-12-01,11,com,8103766,3226955,4876811
2010-12-01,12,com,109089,2681143,-2572054
2010-12-01,13,com,5201174,5688683,-487509
2010-12-01,14,com,9528967,9926942,-397975
2010-12-01,15,com,5551850,1167283,4384567
2010-12-01,16,com,1975073,2663741,-688668
2010-12-01,17,com,8732062,2141077,6590985
2010-12-01,18,com,9422350,810287,8612063
2010-12-01,19,com,7861416,7595246,266170
2010-12-01,20,com,4040487,1498966,2541521
2010-12-01,21,com,9611591,1891711,7719880
2010-12-01,22,com,2127930,3079871,-951941
2010-12-01,23,com,5050633,2224877,2825756
2010-12-01,0,vou,7810282,1479485,6330797
2010-12-01,1,vou,4923613,8134419,-3210806
2010-12-01,2,vou,9328864,7011170,2317694
2010-12-01,3,vou,9803757,3716455,6087302
2010-12-01,4,vou,8319199,6071757,2247442
2010-12-01,5,vou,6520144,4619051,1901093
2010-12-01,6,vou,5662158,5870300,-208142
2010-12-01,7,vou,4278145,6707863,-2429718
2010-12-01,8,vou,4166223,4113197,53026
2010-12-01,9,vou,4665559,2130402,2535157
2010-12-01,10,vou,7660616,4467983,3192633
2010-12-01,11,vou,6280358,1502033,4778325
2010-12-01,12,vou,7366701,7797664,-430963
2010-12-01,13,vou,3239719,2418627,821092
2010-12-01,14,vou,439565,58420,381145
2010-12-01,15,vou,8376364,1455722,6920642
2010-12-01,16,vou,1383997,8768378,-7384381
2010-12-01,17,vou,9888874,4559491,5329383
2010-12-01,18,vou,9593352,8822631,770721
2010-12-01,19,vou,7609819,9602933,-1993114
2010-12-01,20,vou,4733715,7069871,-2336156
2010-12-01,21,vou,6456221,4965322,1490899
2010-12-01,22,vou,9704149,1392182,8311967
2010-12-01,23,vou,4829765,667945,4161820
2010-12-01,0,cm,8080199,6982980,1097219
2010-12-01,1,cm,9373061,8310440,1062621
2010-12-01,2,cm,2723409,2238919,484490
2010-12-01,3,cm,6260473,4518280,1742193
2010-12-01,4,cm,2975748,10010,2965738
2010-12-01,5,cm,1943580,39137,1904443
2010-12-01,6,cm,1671621,3639356,-1967735
2010-12-01,7,cm,357649,8833126,-8475477
2010-12-01,8,cm,3870834,8113079,-4242245
2010-12-01,9,cm,3415031,8712183,-5297152
2010-12-01,10,cm,4820227,2824609,1995618
2010-12-01,11,cm,1513494,328892,1184602
2010-12-01,12,cm,2199950,8307209,-6107259
2010-12-01,13,cm,4322718,5692002,-1369284
2010-12-01,14,cm,5501026,7094103,-1593077
2010-12-01,15,cm,4760540,3222652,1537888
2010-12-01,16,cm,6774084,7882978,-1108894
2010-12-01,17,cm,6233911,8879862,-2645951
2010-12-01,18,cm,2322128,5521873,-3199745
2010-12-01,19,cm,9858816,9454408,404408
2010-12-01,20,cm,6018723,8901753,-2883030
2010-12-01,21,cm,3366499,537731,2828768
2010-12-01,22,cm,9109667,324561,8785106
2010-12-01,23,cm,5043481,3688978,1354503
2010-12-01,0,adj,4316334,5230367,-914033
2010-12-01,1,adj,3204749,2222996,981753
2010-12-01,2,adj,6409016,7935627,-1526611
2010-12-01,3,adj,3939946,8298648,-4358702
2010-12-01,4,adj,3998987,9544830,-5545843
2010-12-01,5,adj,2711203,6453416,-3742213
2010-12-01,6,adj,5379208,6872410,-1493202
2010-12-01,7,adj,5283197,796026,4487171
2010-12-01,8,adj,462882,6384286,-5921404
2010-12-01,9,adj,7808472,7653988,154484
2010-12-01,10,adj,3119988,4319312,-1199324
2010-12-01,11,adj,1081335,4300004,-3218669
2010-12-01,12,adj,8701738,5544170,3157568
2010-12-01,13,adj,6415362,6760842,-345480
2010-12-01,14,adj,9459135,9820774,-361639
2010-12-01,15,adj,4556560,3204636,1351924
2010-12-01,16,adj,1928810,8244633,-6315823
2010-12-01,17,adj,9200377,8057903,1142474
2010-12-01,18,adj,5154816,8564613,-3409797
2010-12-01,19,adj,5721138,2057611,3663527
2010-12-01,20,adj,7269074,3194281,4074793
2010-12-01,21,adj,5724884,3867810,1857074
2010-12-01,22,adj,571324,1425831,-854507
2010-12-01,23,adj,9705774,6921368,2784406
2010-12-01,0,first,7733072,3271440,4461632
2010-12-01,1,first,6297725,2254928,4042797
2010-12-01,2,first,4546829,5457530,-910701
2010-12-01,3,first,7250146,5220466,2029680
2010-12-01,4,first,4797268,3485555,1311713
2010-12-01,5,first,1921364,8602464,-6681100
2010-12-01,6,first,2680737,566583,2114154
2010-12-01,7,first,5425531,4820680,604851
2010-12-01,8,first,8728867,5047678,3681189
2010-12-01,9,first,5926797,4777878,1148919
2010-12-01,10,first,2523880,1163255,1360625
2010-12-01,11,first,3142465,3638725,-496260
2010-12-01,12,first,268989,6624064,-6355075
2010-12-01,13,first,3097953,3768884,-670931
2010-12-01,14,first,2479364,7489199,-5009835
2010-12-01,15,first,6921362,2714849,4206513
2010-12-01,16,first,1585896,7746325,-6160429
2010-12-01,17,first,2132648,1912562,220086
2010-12-01,18,first,4249898,1339788,2910110
2010-12-01,19,first,8658521,7746632,911889
2010-12-01,20,first,3936922,8420601,-4483679
2010-12-01,21,first,1202412,4113959,-2911547
2010-12-01,22,first,3317805,3461984,-144179
2010-12-01,23,first,1739380,6973612,-5234232
2010-12-01,0,mon,3121475,3992706,-871231
2010-12-01,1,mon,4627855,8155235,-3527380
2010-12-01,2,mon,6838109,3728608,3109501
2010-12-01,3,mon,6228819,8575282,-2346463
2010-12-01,4,mon,283020,6258310,-5975290
2010-12-01,5,mon,8662205,8999154,-336949
2010-12-01,6,mon,4959332,7849865,-2890533
2010-12-01,7,mon,6165873,4646079,1519794
2010-12-01,8,mon,299812,5777884,-5478072
2010-12-01,9,mon,1330876,4856815,-3525939
2010-12-01,10,mon,4641892,6515839,-1873947
2010-12-01,11,mon,7515442,3853793,3661649
2010-12-01,12,mon,5806743,3587144,2219599
2010-12-01,13,mon,9340996,2579756,6761240
2010-12-01,14,mon,6254117,4755078,1499039
2010-12-01,15,mon,5537824,5692734,-154910
2010-12-01,16,mon,7903064,7984719,-81655
2010-12-01,17,mon,7420696,6211432,1209264
2010-12-01,18,mon,8928948,51982,8876966
2010-12-01,19,mon,4340800,518783,3822017
2010-12-01,20,mon,8600632,7180213,1420419
2010-12-01,21,mon,7723310,625226,7098084
2010-12-01,22,mon,9158399,2570370,6588029
2010-12-01,23,mon,2374216,8029736,-5655520
2010-12-01,0,data,2638562,425763,2212799
2010-12-01,1,data,1528879,5479026,-3950147
2010-12-01,2,data,6200035,7120648,-920613
2010-12-01,3,data,7092182,3916451,3175731
2010-12-01,4,data,6506560,7392604,-886044
2010-12-01,5,data,3896721,6562644,-2665923
2010-12-01,6,data,3882217,9378005,-5495788
2010-12-01,7,data,4140029,4838183,-698154
2010-12-01,8,data,2270477,1928014,342463
2010-12-01,9,data,8819819,4862045,3957774
2010-12-01,10,data,2193097,9003897,-6810800
2010-12-01,11,data,8046832,8640465,-593633
2010-12-01,12,data,3109858,848374,2261484
2010-12-01,13,data,6634281,8936300,-2302019
2010-12-01,14,data,5170374,5593585,-423211
2010-12-01,15,data,4837505,3687276,1150229
2010-12-01,16,data,7735673,2622274,5113399
2010-12-01,17,data,6645004,1606199,5038805
2010-12-01,18,data,8475215,2271456,6203759
2010-12-01,19,data,7721888,9459188,-1737300
2010-12-01,20,data,2550371,7051409,-4501038
2010-12-01,21,data,5205078,3742029,1463049
2010-12-01,22,data,3800748,1276371,2524377
2010-12-01,23,data,6864388,2808140,4056248
2010-12-01,0,voice,8837108,1769888,7067220
2010-12-01,1,voice,6249028,2899237,3349791
2010-12-01,2,voice,8276202,7740068,536134
2010-12-01,3,voice,4618557,8695250,-4076693
2010-12-01,4,voice,3373994,2749515,624479
2010-12-01,5,voice,6997414,2596277,4401137
2010-12-01,6,voice,5092021,9414781,-4322760
2010-12-01,7,voice,2059826,2262400,-202574
2010-12-01,8,voice,1761066,4419417,-2658351
2010-12-01,9,voice,2884244,659212,2225032
2010-12-01,10,voice,198627,3052681,-2854054
2010-12-01,11,voice,8880729,502438,8378291
2010-12-01,12,voice,9604994,8041991,1563003
2010-12-01,13,voice,259596,2167409,-1907813
2010-12-01,14,voice,5631790,6612022,-980232
2010-12-01,15,voice,4026341,3040044,986297
2010-12-01,16,voice,6774504,3524167,3250337
2010-12-01,17,voice,2440771,3271621,-830850
2010-12-01,18,voice,4248292,2599032,1649260
2010-12-01,19,voice,2964954,1610828,1354126
2010-12-01,20,voice,6589145,7938548,-1349403
2010-12-01,21,voice,6757026,2162305,4594721
2010-12-01,22,voice,4317917,7457619,-3139702
2010-12-01,23,voice,2952073,8268781,-5316708
2010-12-01,0,sms,2643464,2565291,78173
2010-12-01,1,sms,5355217,8359644,-3004427
2010-12-01,2,sms,1930128,4678452,-2748324
2010-12-01,3,sms,6926873,265567,6661306
2010-12-01,4,sms,2549873,9493611,-6943738
2010-12-01,5,sms,811139,1812160,-1001021
2010-12-01,6,sms,8211041,261240,7949801
2010-12-01,7,sms,9628341,2598044,7030297
2010-12-01,8,sms,7238017,2393295,4844722
2010-12-01,9,sms,6459615,6749995,-290380
2010-12-01,10,sms,862654,3119254,-2256600
2010-12-01,11,sms,7019259,4918985,2100274
2010-12-01,12,sms,8372016,7953597,418419
2010-12-01,13,sms,9181542,9228353,-46811
2010-12-01,14,sms,5296599,5023592,273007
2010-12-01,15,sms,4915012,4329743,585269
2010-12-01,16,sms,60,4440229,-4440169
2010-12-01,17,sms,819739,9901128,-9081389
2010-12-01,18,sms,6456287,2548917,3907370
2010-12-01,19,sms,8923350,8273243,650107
2010-12-01,20,sms,3562472,7022542,-3460070
2010-12-01,21,sms,9940143,5867075,4073068
2010-12-01,22,sms,6641751,1791874,4849877
2010-12-01,23,sms,2806908,310883,2496025
2010-12-01,0,clr,7221419,7713202,-491783
2010-12-01,1,clr,5292785,4282197,1010588
2010-12-01,2,clr,860959,3763241,-2902282
2010-12-01,3,clr,2458126,2026097,432029
2010-12-01,4,clr,9364978,9499444,-134466
2010-12-01,5,clr,7205335,5437807,1767528
2010-12-01,6,clr,7702020,3778423,3923597
2010-12-01,7,clr,3697575,3990605,-293030
2010-12-01,8,clr,6584257,5895194,689063
2010-12-01,9,clr,8212263,7470213,742050
2010-12-01,10,clr,3729599,3092896,636703
2010-12-01,11,clr,9327620,7378382,1949238
2010-12-01,12,clr,215188,2354405,-2139217
2010-12-01,13,clr,6524644,1994029,4530615
2010-12-01,14,clr,4793332,2296910,2496422
2010-12-01,15,clr,8550949,2270240,6280709
2010-12-01,16,clr,9527673,7982245,1545428
2010-12-01,17,clr,853988,667393,186595
2010-12-01,18,clr,3525994,9122542,-5596548
2010-12-01,19,clr,1051582,8125419,-7073837
2010-12-01,20,clr,3960075,7649758,-3689683
2010-12-01,21,clr,9081031,9476884,-395853
2010-12-01,22,clr,9464715,4037773,5426942
2010-12-01,23,clr,3983013,9252701,-5269688
2010-12-02,0,com,5735014,466217,5268797
2010-12-02,1,com,9674711,1759828,7914883
2010-12-02,2,com,5087823,5330601,-242778
2010-12-02,3,com,7899424,478003,7421421
2010-12-02,4,com,5221302,8376599,-3155297
2010-12-02,5,com,2231795,7157363,-4925568
2010-12-02,6,com,3312376,9869451,-6557075
2010-12-02,7,com,5497155,7277806,-1780651
2010-12-02,8,com,969315,4674194,-3704879
2010-12-02,9,com,8724872,1733831,6991041
2010-12-02,10,com,5081247,6092376,-1011129
2010-12-02,11,com,6195949,1891096,4304853
2010-12-02,12,com,1981906,2580264,-598358
2010-12-02,13,com,2236766,5631147,-3394381
2010-12-02,14,com,9417250,4592325,4824925
2010-12-02,15,com,8385510,2205419,6180091
2010-12-02,16,com,5862987,1991347,3871640
2010-12-02,17,com,9367232,9091017,276215
2010-12-02,18,com,8274866,3319282,4955584
2010-12-02,19,com,1398432,1155695,242737
2010-12-02,20,com,6615318,7223901,-608583
2010-12-02,21,com,3010563,5379026,-2368463
2010-12-02,22,com,8268084,7908479,359605
2010-12-02,23,com,1032559,9081706,-8049147
2010-12-02,0,vou,5460539,1600532,3860007
2010-12-02,1,vou,2714099,2376970,337129
2010-12-02,2,vou,2570958,4023765,-1452807
2010-12-02,3,vou,6284610,668136,5616474
2010-12-02,4,vou,2737886,9625764,-6887878
2010-12-02,5,vou,4423272,6425686,-2002414
2010-12-02,6,vou,6302443,9716305,-3413862
2010-12-02,7,vou,4082954,2363462,1719492
2010-12-02,8,vou,9014724,1756950,7257774
2010-12-02,9,vou,9726309,3757038,5969271
2010-12-02,10,vou,4172030,7788070,-3616040
2010-12-02,11,vou,1321960,8832430,-7510470
2010-12-02,12,vou,7909633,229817,7679816
2010-12-02,13,vou,6912622,1014,6911608
2010-12-02,14,vou,8681239,5659797,3021442
2010-12-02,15,vou,6633344,7000921,-367577
2010-12-02,16,vou,9256833,7262678,1994155
2010-12-02,17,vou,8201864,714503,7487361
2010-12-02,18,vou,5490988,3406656,2084332
2010-12-02,19,vou,7217274,8615689,-1398415
2010-12-02,20,vou,544866,1503514,-958648
2010-12-02,21,vou,7023739,47276,6976463
2010-12-02,22,vou,1455217,295822,1159395
2010-12-02,23,vou,612175,8027082,-7414907
2010-12-02,0,cm,1766071,2211603,-445532
2010-12-02,1,cm,614099,2226447,-1612348
2010-12-02,2,cm,3739909,6444829,-2704920
2010-12-02,3,cm,8457762,8451470,6292
2010-12-02,4,cm,7587647,9456038,-1868391
2010-12-02,5,cm,5694799,7273271,-1578472
2010-12-02,6,cm,4153642,1553449,2600193
2010-12-02,7,cm,1810574,7560818,-5750244
2010-12-02,8,cm,5204644,1371043,3833601
2010-12-02,9,cm,8857230,8992152,-134922
2010-12-02,10,cm,2124030,3653490,-1529460
2010-12-02,11,cm,3538846,633127,2905719
2010-12-02,12,cm,8695219,5823786,2871433
2010-12-02,13,cm,5949426,472829,5476597
2010-12-02,14,cm,3919492,531944,3387548
2010-12-02,15,cm,4194721,8901050,-4706329
2010-12-02,16,cm,6432617,3296220,3136397
2010-12-02,17,cm,5116486,9194493,-4078007
2010-12-02,18,cm,6073621,3440381,2633240
2010-12-02,19,cm,7364995,6402009,962986
2010-12-02,20,cm,5128402,5781131,-652729
2010-12-02,21,cm,6077993,951756,5126237
2010-12-02,22,cm,9922607,8076399,1846208
2010-12-02,23,cm,8861545,5419395,3442150
2010-12-02,0,adj,7925582,8333754,-408172
2010-12-02,1,adj,3079290,2797718,281572
2010-12-02,2,adj,7509883,1614176,5895707
2010-12-02,3,adj,4853994,7728165,-2874171
2010-12-02,4,adj,5020710,2542335,2478375
2010-12-02,5,adj,5994577,7139013,-1144436
2010-12-02,6,adj,1455717,4800661,-3344944
2010-12-02,7,adj,3327186,1878619,1448567
2010-12-02,8,adj,504188,3731359,-3227171
2010-12-02,9,adj,1189537,8249820,-7060283
2010-12-02,10,adj,5122944,6397740,-1274796
2010-12-02,11,adj,2071208,6332333,-4261125
2010-12-02,12,adj,8712019,2095924,6616095
2010-12-02,13,adj,5540318,1193533,4346785
2010-12-02,14,adj,5147635,3802712,1344923
2010-12-02,15,adj,6333721,4227046,2106675
2010-12-02,16,adj,6074879,9132347,-3057468
2010-12-02,17,adj,7381032,8775525,-1394493
2010-12-02,18,adj,7460055,6596256,863799
2010-12-02,19,adj,4978745,275495,4703250
2010-12-02,20,adj,8852575,906005,7946570
2010-12-02,21,adj,1907147,9004158,-7097011
2010-12-02,22,adj,3395164,1315697,2079467
2010-12-02,23,adj,9593183,9401280,191903
2010-12-02,0,first,5267350,1942152,3325198
2010-12-02,1,first,6594291,3810494,2783797
2010-12-02,2,first,4519615,7369563,-2849948
2010-12-02,3,first,9736835,8545444,1191391
2010-12-02,4,first,9556327,2680991,6875336
2010-12-02,5,first,8646066,1951562,6694504
2010-12-02,6,first,9766590,7053399,2713191
2010-12-02,7,first,9973500,414217,9559283
2010-12-02,8,first,8617805,7197346,1420459
2010-12-02,9,first,7045528,98364,6947164
2010-12-02,10,first,5451025,2750704,2700321
2010-12-02,11,first,5363410,6296570,-933160
2010-12-02,12,first,7261927,3900979,3360948
2010-12-02,13,first,865577,9465159,-8599582
2010-12-02,14,first,6727819,7092522,-364703
2010-12-02,15,first,1126440,4306432,-3179992
2010-12-02,16,first,9702522,4149906,5552616
2010-12-02,17,first,4915108,5711548,-796440
2010-12-02,18,first,9338248,6654060,2684188
2010-12-02,19,first,2382898,8665744,-6282846
2010-12-02,20,first,5444977,9625844,-4180867
2010-12-02,21,first,917945,4940540,-4022595
2010-12-02,22,first,8718011,3372906,5345105
2010-12-02,23,first,1851503,6191019,-4339516
2010-12-02,0,mon,5161960,8612546,-3450586
2010-12-02,1,mon,1818406,8144439,-6326033
2010-12-02,2,mon,6884957,98104,6786853
2010-12-02,3,mon,560151,5274095,-4713944
2010-12-02,4,mon,230458,4686273,-4455815
2010-12-02,5,mon,4257141,1663121,2594020
2010-12-02,6,mon,2028033,8594804,-6566771
2010-12-02,7,mon,4156845,8339325,-4182480
2010-12-02,8,mon,5858962,4301449,1557513
2010-12-02,9,mon,579581,8080535,-7500954
2010-12-02,10,mon,5592598,4920342,672256
2010-12-02,11,mon,5744655,8248727,-2504072
2010-12-02,12,mon,5663687,1800683,3863004
2010-12-02,13,mon,7641010,5928062,1712948
2010-12-02,14,mon,523999,4034464,-3510465
2010-12-02,15,mon,9878727,5998223,3880504
2010-12-02,16,mon,8995530,7592410,1403120
2010-12-02,17,mon,2471717,5593068,-3121351
2010-12-02,18,mon,4188484,1367287,2821197
2010-12-02,19,mon,7725789,5502380,2223409
2010-12-02,20,mon,1681948,6729611,-5047663
2010-12-02,21,mon,7338059,9330600,-1992541
2010-12-02,22,mon,380514,2599029,-2218515
2010-12-02,23,mon,6404079,8035785,-1631706
2010-12-02,0,data,8144573,5401936,2742637
2010-12-02,1,data,8012283,7035786,976497
2010-12-02,2,data,2093306,1231818,861488
2010-12-02,3,data,2242060,2289672,-47612
2010-12-02,4,data,9335047,2571269,6763778
2010-12-02,5,data,8465766,6441489,2024277
2010-12-02,6,data,7466671,6606240,860431
2010-12-02,7,data,7746819,6852661,894158
2010-12-02,8,data,3115620,6273573,-3157953
2010-12-02,9,data,2333787,3905617,-1571830
2010-12-02,10,data,9591577,1753835,7837742
2010-12-02,11,data,966870,1921175,-954305
2010-12-02,12,data,8109998,8809234,-699236
2010-12-02,13,data,2327498,9090639,-6763141
2010-12-02,14,data,8200781,4241718,3959063
2010-12-02,15,data,8009953,660314,7349639
2010-12-02,16,data,5867533,5237765,629768
2010-12-02,17,data,3935997,8845324,-4909327
2010-12-02,18,data,2962718,7719802,-4757084
2010-12-02,19,data,3109413,8191271,-5081858
2010-12-02,20,data,4260145,66587,4193558
2010-12-02,21,data,8220902,3057828,5163074
2010-12-02,22,data,3361037,3953017,-591980
2010-12-02,23,data,8835255,9061404,-226149
2010-12-02,0,voice,6627373,2793069,3834304
2010-12-02,1,voice,7470797,5493904,1976893
2010-12-02,2,voice,9008777,3832814,5175963
2010-12-02,3,voice,895764,2448321,-1552557
2010-12-02,4,voice,8042812,351013,7691799
2010-12-02,5,voice,4758505,103089,4655416
2010-12-02,6,voice,4908646,2488516,2420130
2010-12-02,7,voice,4022525,2690186,1332339
2010-12-02,8,voice,1489800,5844263,-4354463
2010-12-02,9,voice,8780546,1612499,7168047
2010-12-02,10,voice,7912357,7261611,650746
2010-12-02,11,voice,1047276,2795212,-1747936
2010-12-02,12,voice,1429343,9461176,-8031833
2010-12-02,13,voice,2477990,9605572,-7127582
2010-12-02,14,voice,2386835,5378505,-2991670
2010-12-02,15,voice,8993301,8088675,904626
2010-12-02,16,voice,9258684,6385757,2872927
2010-12-02,17,voice,5998311,4405071,1593240
2010-12-02,18,voice,3227746,4360397,-1132651
2010-12-02,19,voice,3702285,9086511,-5384226
2010-12-02,20,voice,4779339,4043115,736224
2010-12-02,21,voice,4156156,9040666,-4884510
2010-12-02,22,voice,1347706,1435941,-88235
2010-12-02,23,voice,7353767,9486802,-2133035
2010-12-02,0,sms,4883151,7409819,-2526668
2010-12-02,1,sms,5673113,8346708,-2673595
2010-12-02,2,sms,336595,1372285,-1035690
2010-12-02,3,sms,9049449,2631839,6417610
2010-12-02,4,sms,5871407,4867221,1004186
2010-12-02,5,sms,8605707,3185629,5420078
2010-12-02,6,sms,7889798,6895206,994592
2010-12-02,7,sms,7451144,2358099,5093045
2010-12-02,8,sms,9230818,263457,8967361
2010-12-02,9,sms,3191862,1011387,2180475
2010-12-02,10,sms,6285239,9584845,-3299606
2010-12-02,11,sms,8304849,4501023,3803826
2010-12-02,12,sms,6950878,8463498,-1512620
2010-12-02,13,sms,471600,5798746,-5327146
2010-12-02,14,sms,3914058,9829967,-5915909
2010-12-02,15,sms,491440,5723310,-5231870
2010-12-02,16,sms,5120924,8618949,-3498025
2010-12-02,17,sms,9825033,2036263,7788770
2010-12-02,18,sms,4964438,7560924,-2596486
2010-12-02,19,sms,9399285,7995505,1403780
2010-12-02,20,sms,7353368,6203477,1149891
2010-12-02,21,sms,6226778,4505806,1720972
2010-12-02,22,sms,9206099,7742426,1463673
2010-12-02,23,sms,287231,3565417,-3278186
2010-12-02,0,clr,2009631,1774800,234831
2010-12-02,1,clr,680267,5992200,-5311933
2010-12-02,2,clr,9934438,1358220,8576218
2010-12-02,3,clr,4582346,6374078,-1791732
2010-12-02,4,clr,8541052,4280465,4260587
2010-12-02,5,clr,6813096,9670417,-2857321
2010-12-02,6,clr,6736953,7805537,-1068584
2010-12-02,7,clr,6418511,8934745,-2516234
2010-12-02,8,clr,2707599,7988105,-5280506
2010-12-02,9,clr,6502276,453456,6048820
2010-12-02,10,clr,3037513,9523803,-6486290
2010-12-02,11,clr,5126830,3150371,1976459
2010-12-02,12,clr,2798517,3955033,-1156516
2010-12-02,13,clr,9175401,8001619,1173782
2010-12-02,14,clr,9103012,5514554,3588458
2010-12-02,15,clr,2519612,8741698,-6222086
2010-12-02,16,clr,3039985,7436139,-4396154
2010-12-02,17,clr,4753177,6289719,-1536542
2010-12-02,18,clr,9511370,89008,9422362
2010-12-02,19,clr,3074898,2972479,102419
2010-12-02,20,clr,2198058,9827454,-7629396
2010-12-02,21,clr,8000377,3454340,4546037
2010-12-02,22,clr,9205097,1342585,7862512
2010-12-02,23,clr,174729,5396721,-5221992
2010-12-03,0,com,1612083,8356043,-6743960
2010-12-03,1,com,9820741,5317437,4503304
2010-12-03,2,com,1460522,8494298,-7033776
2010-12-03,3,com,1890578,1434881,455697
2010-12-03,4,com,2640068,2230194,409874
2010-12-03,5,com,7426838,3194350,4232488
2010-12-03,6,com,1024067,8690182,-7666115
2010-12-03,7,com,9212592,4820003,4392589
2010-12-03,8,com,8956498,3429226,5527272
2010-12-03,9,com,3459996,4238190,-778194
2010-12-03,10,com,8585594,1971624,6613970
2010-12-03,11,com,6974315,8503895,-1529580
2010-12-03,12,com,5272330,3608722,1663608
2010-12-03,13,com,959013,7687046,-6728033
2010-12-03,14,com,9606878,6453093,3153785
2010-12-03,15,com,2957611,5647037,-2689426
2010-12-03,16,com,6248438,3403640,2844798
2010-12-03,17,com,3171703,521921,2649782
2010-12-03,18,com,5945225,148457,5796768
2010-12-03,19,com,8101396,3713643,4387753
2010-12-03,20,com,2134202,7726150,-5591948
2010-12-03,21,com,8703332,7003747,1699585
2010-12-03,22,com,6076822,4015034,2061788
2010-12-03,23,com,656559,8534763,-7878204
2010-12-03,0,vou,2707761,9404359,-6696598
2010-12-03,1,vou,5355165,1954604,3400561
2010-12-03,2,vou,731025,1229961,-498936
2010-12-03,3,vou,1222482,474896,747586
2010-12-03,4,vou,7304819,7530829,-226010
2010-12-03,5,vou,606802,9226561,-8619759
2010-12-03,6,vou,6676142,2625101,4051041
2010-12-03,7,vou,6020030,7386598,-1366568
2010-12-03,8,vou,3506684,4720819,-1214135
2010-12-03,9,vou,5057914,2194920,2862994
2010-12-03,10,vou,3530532,2118867,1411665
2010-12-03,11,vou,9865543,4897199,4968344
2010-12-03,12,vou,8483550,635319,7848231
2010-12-03,13,vou,3758935,160281,3598654
2010-12-03,14,vou,5207148,9873465,-4666317
2010-12-03,15,vou,5953842,9388365,-3434523
2010-12-03,16,vou,1405535,5705884,-4300349
2010-12-03,17,vou,1440720,2568650,-1127930
2010-12-03,18,vou,322084,7898693,-7576609
2010-12-03,19,vou,9597945,7488171,2109774
2010-12-03,20,vou,9108705,8068306,1040399
2010-12-03,21,vou,2018078,2018125,-47
2010-12-03,22,vou,4529227,9102404,-4573177
2010-12-03,23,vou,990624,4788134,-3797510
2010-12-03,0,cm,9889918,9815408,74510
2010-12-03,1,cm,429960,6965650,-6535690
2010-12-03,2,cm,3991046,8944930,-4953884
2010-12-03,3,cm,981602,1250172,-268570
2010-12-03,4,cm,1454189,7315649,-5861460
2010-12-03,5,cm,4002295,4852633,-850338
2010-12-03,6,cm,76259,7793487,-7717228
2010-12-03,7,cm,9543549,4776814,4766735
2010-12-03,8,cm,9502428,4560607,4941821
2010-12-03,9,cm,9537373,6977950,2559423
2010-12-03,10,cm,8246828,3297988,4948840
2010-12-03,11,cm,5315933,5255084,60849
2010-12-03,12,cm,4772491,1220357,3552134
2010-12-03,13,cm,6226691,2533654,3693037
2010-12-03,14,cm,1848117,4887942,-3039825
2010-12-03,15,cm,1093676,3455694,-2362018
2010-12-03,16,cm,6363069,4017253,2345816
2010-12-03,17,cm,7579867,1002802,6577065
2010-12-03,18,cm,8864693,1980159,6884534
2010-12-03,19,cm,440564,6100840,-5660276
2010-12-03,20,cm,2449905,3602165,-1152260
2010-12-03,21,cm,3521985,2646351,875634
2010-12-03,22,cm,1935059,1957471,-22412
2010-12-03,23,cm,9108969,7892331,1216638
2010-12-03,0,adj,7810249,6979171,831078
2010-12-03,1,adj,6096406,3753811,2342595
2010-12-03,2,adj,5762424,1670847,4091577
2010-12-03,3,adj,7539721,3769776,3769945
2010-12-03,4,adj,2600923,1878017,722906
2010-12-03,5,adj,4738675,5612277,-873602
2010-12-03,6,adj,2649608,8928105,-6278497
2010-12-03,7,adj,2057788,995156,1062632
2010-12-03,8,adj,6008098,920407,5087691
2010-12-03,9,adj,9631431,7840625,1790806
2010-12-03,10,adj,5490261,3292148,2198113
2010-12-03,11,adj,8222178,489873,7732305
2010-12-03,12,adj,7748341,9090417,-1342076
2010-12-03,13,adj,4624050,3587982,1036068
2010-12-03,14,adj,7421292,2183671,5237621
2010-12-03,15,adj,8439279,7633718,805561
2010-12-03,16,adj,7862910,5561880,2301030
2010-12-03,17,adj,38172,9167258,-9129086
2010-12-03,18,adj,9369395,3166747,6202648
2010-12-03,19,adj,3017827,5281759,-2263932
2010-12-03,20,adj,4486301,73391,4412910
2010-12-03,21,adj,751933,7495821,-6743888
2010-12-03,22,adj,8484015,6973594,1510421
2010-12-03,23,adj,803251,4376264,-3573013
2010-12-03,0,first,9899381,7306332,2593049
2010-12-03,1,first,7825020,7247614,577406
2010-12-03,2,first,9418917,3218761,6200156
2010-12-03,3,first,4968784,922331,4046453
2010-12-03,4,first,4257182,8940460,-4683278
2010-12-03,5,first,6342722,5316037,1026685
2010-12-03,6,first,7817887,8405041,-587154
2010-12-03,7,first,9371501,4532632,4838869
2010-12-03,8,first,134751,8731324,-8596573
2010-12-03,9,first,1281451,6075706,-4794255
2010-12-03,10,first,5896196,1927230,3968966
2010-12-03,11,first,7371480,8789461,-1417981
2010-12-03,12,first,2625861,4815119,-2189258
2010-12-03,13,first,8740815,4047650,4693165
2010-12-03,14,first,2330148,7635578,-5305430
2010-12-03,15,first,2532203,7555129,-5022926
2010-12-03,16,first,4577145,8700462,-4123317
2010-12-03,17,first,1023505,903918,119587
2010-12-03,18,first,5801607,7127025,-1325418
2010-12-03,19,first,1520296,8583460,-7063164
2010-12-03,20,first,5216639,5679495,-462856
2010-12-03,21,first,4405402,8138453,-3733051
2010-12-03,22,first,1281896,6407622,-5125726
2010-12-03,23,first,6489013,2272895,4216118
2010-12-03,0,mon,9483697,9883594,-399897
2010-12-03,1,mon,3105121,1561409,1543712
2010-12-03,2,mon,2525715,9512671,-6986956
2010-12-03,3,mon,3021135,8829806,-5808671
2010-12-03,4,mon,2438691,8184895,-5746204
2010-12-03,5,mon,5194514,8912874,-3718360
2010-12-03,6,mon,5074951,5890259,-815308
2010-12-03,7,mon,3230963,8502027,-5271064
2010-12-03,8,mon,3789008,8341495,-4552487
2010-12-03,9,mon,8573724,6333093,2240631
2010-12-03,10,mon,8065651,3830741,4234910
2010-12-03,11,mon,1098239,302495,795744
2010-12-03,12,mon,1665165,5336960,-3671795
2010-12-03,13,mon,3763388,6173539,-2410151
2010-12-03,14,mon,5211171,4732051,479120
2010-12-03,15,mon,5441922,9332623,-3890701
2010-12-03,16,mon,4703605,1148612,3554993
2010-12-03,17,mon,3653442,2988144,665298
2010-12-03,18,mon,3890372,5162648,-1272276
2010-12-03,19,mon,9127861,915828,8212033
2010-12-03,20,mon,6092901,4493072,1599829
2010-12-03,21,mon,1034108,2163808,-1129700
2010-12-03,22,mon,2521599,8648548,-6126949
2010-12-03,23,mon,5334173,4571547,762626
2010-12-03,0,data,2839123,407095,2432028
2010-12-03,1,data,8919690,4692655,4227035
2010-12-03,2,data,1780918,7674523,-5893605
2010-12-03,3,data,9019126,2504772,6514354
2010-12-03,4,data,7921948,6041920,1880028
2010-12-03,5,data,4122160,8901206,-4779046
2010-12-03,6,data,2420672,8955769,-6535097
2010-12-03,7,data,2981341,3356514,-375173
2010-12-03,8,data,8063555,7096891,966664
2010-12-03,9,data,4613956,3957455,656501
2010-12-03,10,data,8672976,285146,8387830
2010-12-03,11,data,6555129,3167906,3387223
2010-12-03,12,data,4807756,4534946,272810
2010-12-03,13,data,1481934,7127230,-5645296
2010-12-03,14,data,939724,2322638,-1382914
2010-12-03,15,data,9924490,6570267,3354223
2010-12-03,16,data,9187752,6388528,2799224
2010-12-03,17,data,401931,2236602,-1834671
2010-12-03,18,data,276683,934588,-657905
2010-12-03,19,data,8670957,6436612,2234345
2010-12-03,20,data,4234953,1188876,3046077
2010-12-03,21,data,1181934,5307637,-4125703
2010-12-03,22,data,4584050,8201217,-3617167
2010-12-03,23,data,9403971,3667200,5736771
2010-12-03,0,voice,1301435,4220183,-2918748
2010-12-03,1,voice,1632680,5203389,-3570709
2010-12-03,2,voice,42508,1974607,-1932099
2010-12-03,3,voice,3123840,8521907,-5398067
2010-12-03,4,voice,7413000,7310835,102165
2010-12-03,5,voice,8372234,1877528,6494706
2010-12-03,6,voice,3447805,7102698,-3654893
2010-12-03,7,voice,8918461,7645690,1272771
2010-12-03,8,voice,3690093,6060997,-2370904
2010-12-03,9,voice,5330206,5196194,134012
2010-12-03,10,voice,1368821,4894676,-3525855
2010-12-03,11,voice,5252150,5568347,-316197
2010-12-03,12,voice,5233171,5291246,-58075
2010-12-03,13,voice,462503,7140193,-6677690
2010-12-03,14,voice,5043628,396498,4647130
2010-12-03,15,voice,9214777,9601687,-386910
2010-12-03,16,voice,3168911,8589030,-5420119
2010-12-03,17,voice,3859294,9290561,-5431267
2010-12-03,18,voice,3021939,9003479,-5981540
2010-12-03,19,voice,5826759,7665746,-1838987
2010-12-03,20,voice,6632788,7590660,-957872
2010-12-03,21,voice,7204654,627626,6577028
2010-12-03,22,voice,341901,6178617,-5836716
2010-12-03,23,voice,2558831,6466635,-3907804
2010-12-03,0,sms,2331278,3656407,-1325129
2010-12-03,1,sms,5658888,5934649,-275761
2010-12-03,2,sms,9366769,9697914,-331145
2010-12-03,3,sms,4426574,1468107,2958467
2010-12-03,4,sms,484578,4267565,-3782987
2010-12-03,5,sms,50608,7460908,-7410300
2010-12-03,6,sms,61025,8976369,-8915344
2010-12-03,7,sms,5767257,5045489,721768
2010-12-03,8,sms,1280155,5738291,-4458136
2010-12-03,9,sms,3958439,9381683,-5423244
2010-12-03,10,sms,5308549,5224610,83939
2010-12-03,11,sms,2026658,5119964,-3093306
2010-12-03,12,sms,9004937,5183088,3821849
2010-12-03,13,sms,2523483,725865,1797618
2010-12-03,14,sms,2489578,2843503,-353925
2010-12-03,15,sms,6301356,1467281,4834075
2010-12-03,16,sms,907501,8968119,-8060618
2010-12-03,17,sms,6116340,7564327,-1447987
2010-12-03,18,sms,3844694,6360403,-2515709
2010-12-03,19,sms,4708325,4742665,-34340
2010-12-03,20,sms,5940936,7438414,-1497478
2010-12-03,21,sms,7282535,27090,7255445
2010-12-03,22,sms,2512082,3265060,-752978
2010-12-03,23,sms,6869889,1607401,5262488
2010-12-03,0,clr,877680,7851153,-6973473
2010-12-03,1,clr,9949243,1625827,8323416
2010-12-03,2,clr,2721215,8922752,-6201537
2010-12-03,3,clr,4275369,2954367,1321002
2010-12-03,4,clr,8485964,8722263,-236299
2010-12-03,5,clr,9102657,9920987,-818330
2010-12-03,6,clr,1125683,594350,531333
2010-12-03,7,clr,5302617,9403605,-4100988
2010-12-03,8,clr,9936795,9052422,884373
2010-12-03,9,clr,3326035,1853317,1472718
2010-12-03,10,clr,1362833,9856467,-8493634
2010-12-03,11,clr,3273544,117653,3155891
2010-12-03,12,clr,6821705,2325162,4496543
2010-12-03,13,clr,8837949,6799521,2038428
2010-12-03,14,clr,9351407,1338835,8012572
2010-12-03,15,clr,7498495,4343138,3155357
2010-12-03,16,clr,539287,9839063,-9299776
2010-12-03,17,clr,7123254,6943256,179998
2010-12-03,18,clr,8608665,6246087,2362578
2010-12-03,19,clr,6117132,4205268,1911864
2010-12-03,20,clr,4161129,3158810,1002319
2010-12-03,21,clr,9106741,260550,8846191
2010-12-03,22,clr,1011225,8516110,-7504885
2010-12-03,23,clr,2258541,526368,1732173
2010-12-04,0,com,8067427,7369807,697620
2010-12-04,1,com,890536,2124777,-1234241
2010-12-04,2,com,2972688,6260921,-3288233
2010-12-04,3,com,6563570,8684897,-2121327
2010-12-04,4,com,2941124,9265266,-6324142
2010-12-04,5,com,843233,4011848,-3168615
2010-12-04,6,com,1665128,8697809,-7032681
2010-12-04,7,com,2630473,6189467,-3558994
2010-12-04,8,com,9386208,7548757,1837451
2010-12-04,9,com,5956538,1422952,4533586
2010-12-04,10,com,5955548,1506738,4448810
2010-12-04,11,com,5631837,7495129,-1863292
2010-12-04,12,com,6983574,5218104,1765470
2010-12-04,13,com,3770734,1346243,2424491
2010-12-04,14,com,8885040,1990848,6894192
2010-12-04,15,com,8392838,2302776,6090062
2010-12-04,16,com,3901598,6638449,-2736851
2010-12-04,17,com,6286944,2387069,3899875
2010-12-04,18,com,4251536,5594177,-1342641
2010-12-04,19,com,9331582,9877078,-545496
2010-12-04,20,com,9789874,4976280,4813594
2010-12-04,21,com,7530227,4240194,3290033
2010-12-04,22,com,2855794,9496675,-6640881
2010-12-04,23,com,9734541,8145757,1588784
2010-12-04,0,vou,1428815,1313170,115645
2010-12-04,1,vou,7868593,7087847,780746
2010-12-04,2,vou,8652637,8044568,608069
2010-12-04,3,vou,3297647,3743199,-445552
2010-12-04,4,vou,2791224,412380,2378844
2010-12-04,5,vou,1363333,6501479,-5138146
2010-12-04,6,vou,9663347,9557330,106017
2010-12-04,7,vou,2920939,2389802,531137
2010-12-04,8,vou,7466207,5269361,2196846
2010-12-04,9,vou,1210734,8810937,-7600203
2010-12-04,10,vou,8778207,9942740,-1164533
2010-12-04,11,vou,7873493,8388116,-514623
2010-12-04,12,vou,5760110,5091750,668360
2010-12-04,13,vou,4639270,8782966,-4143696
2010-12-04,14,vou,1842771,4365696,-2522925
2010-12-04,15,vou,1720415,3780643,-2060228
2010-12-04,16,vou,175953,1012853,-836900
2010-12-04,17,vou,8764704,3061216,5703488
2010-12-04,18,vou,8750797,8780817,-30020
2010-12-04,19,vou,8039419,1742189,6297230
2010-12-04,20,vou,7278172,1481973,5796199
2010-12-04,21,vou,9823106,7854471,1968635
2010-12-04,22,vou,9934178,325871,9608307
2010-12-04,23,vou,4443564,1500943,2942621
2010-12-04,0,cm,911839,4760012,-3848173
2010-12-04,1,cm,5256392,3097917,2158475
2010-12-04,2,cm,789612,1451457,-661845
2010-12-04,3,cm,77772,3380152,-3302380
2010-12-04,4,cm,779763,5591314,-4811551
2010-12-04,5,cm,5202738,7921395,-2718657
2010-12-04,6,cm,8448492,3641326,4807166
2010-12-04,7,cm,717091,9906259,-9189168
2010-12-04,8,cm,3724471,6472060,-2747589
2010-12-04,9,cm,8876809,621316,8255493
2010-12-04,10,cm,4325727,4654744,-329017
2010-12-04,11,cm,8176025,5462260,2713765
2010-12-04,12,cm,4219225,5614160,-1394935
2010-12-04,13,cm,7898004,4809411,3088593
2010-12-04,14,cm,97400,4687830,-4590430
2010-12-04,15,cm,5545615,1196681,4348934
2010-12-04,16,cm,8694044,9032347,-338303
2010-12-04,17,cm,1267683,5171963,-3904280
2010-12-04,18,cm,2422869,8836294,-6413425
2010-12-04,19,cm,5110271,5544195,-433924
2010-12-04,20,cm,459157,2910128,-2450971
2010-12-04,21,cm,1945843,6237585,-4291742
2010-12-04,22,cm,3586688,8575339,-4988651
2010-12-04,23,cm,2186024,2730540,-544516
2010-12-04,0,adj,2091369,615764,1475605
2010-12-04,1,adj,2743361,18833,2724528
2010-12-04,2,adj,6466614,2795361,3671253
2010-12-04,3,adj,4066883,110811,3956072
2010-12-04,4,adj,1822783,2398163,-575380
2010-12-04,5,adj,9875513,8120455,1755058
2010-12-04,6,adj,5711687,1622539,4089148
2010-12-04,7,adj,8795702,319815,8475887
2010-12-04,8,adj,5436562,310190,5126372
2010-12-04,9,adj,1167832,7106886,-5939054
2010-12-04,10,adj,8481679,5499870,2981809
2010-12-04,11,adj,445531,7208074,-6762543
2010-12-04,12,adj,176335,9440086,-9263751
2010-12-04,13,adj,7752067,8692844,-940777
2010-12-04,14,adj,2123409,2616720,-493311
2010-12-04,15,adj,5180419,455137,4725282
2010-12-04,16,adj,8998362,1731963,7266399
2010-12-04,17,adj,924914,6387192,-5462278
2010-12-04,18,adj,9346685,6449797,2896888
2010-12-04,19,adj,1984465,4961105,-2976640
2010-12-04,20,adj,7334688,6144461,1190227
2010-12-04,21,adj,3268476,6049266,-2780790
2010-12-04,22,adj,8037147,2748068,5289079
2010-12-04,23,adj,6704421,8466368,-1761947
2010-12-04,0,first,4546642,8456285,-3909643
2010-12-04,1,first,1126919,324203,802716
2010-12-04,2,first,5584102,1284237,4299865
2010-12-04,3,first,1253313,7981109,-6727796
2010-12-04,4,first,6542108,8244878,-1702770
2010-12-04,5,first,5981526,1227798,4753728
2010-12-04,6,first,427144,6778300,-6351156
2010-12-04,7,first,1004264,3481865,-2477601
2010-12-04,8,first,6516046,4052718,2463328
2010-12-04,9,first,665556,8643819,-7978263
2010-12-04,10,first,6316410,5261109,1055301
2010-12-04,11,first,7145012,8015708,-870696
2010-12-04,12,first,1211074,8839281,-7628207
2010-12-04,13,first,1279477,7607486,-6328009
2010-12-04,14,first,5137148,7974734,-2837586
2010-12-04,15,first,2312019,8229946,-5917927
2010-12-04,16,first,2544125,7387885,-4843760
2010-12-04,17,first,3108032,5222155,-2114123
2010-12-04,18,first,7513205,7899179,-385974
2010-12-04,19,first,8860711,8156036,704675
2010-12-04,20,first,8347931,1553166,6794765
2010-12-04,21,first,5527916,920489,4607427
2010-12-04,22,first,4872059,2298579,2573480
2010-12-04,23,first,5686314,9287530,-3601216
2010-12-04,0,mon,7077246,7852813,-775567
2010-12-04,1,mon,3296851,5389987,-2093136
2010-12-04,2,mon,9740547,8241590,1498957
2010-12-04,3,mon,163659,5035084,-4871425
2010-12-04,4,mon,2802421,4951383,-2148962
2010-12-04,5,mon,3837377,8002686,-4165309
2010-12-04,6,mon,4282412,5251494,-969082
2010-12-04,7,mon,6197865,1923396,4274469
2010-12-04,8,mon,8743418,3323126,5420292
2010-12-04,9,mon,6970705,3925561,3045144
2010-12-04,10,mon,5026778,1992053,3034725
2010-12-04,11,mon,161179,870175,-708996
2010-12-04,12,mon,7645099,1958307,5686792
2010-12-04,13,mon,4480234,8877706,-4397472
2010-12-04,14,mon,3155716,4822717,-1667001
2010-12-04,15,mon,4434636,7963064,-3528428
2010-12-04,16,mon,3031153,5257928,-2226775
2010-12-04,17,mon,8933694,5440170,3493524
2010-12-04,18,mon,6969818,6327385,642433
2010-12-04,19,mon,1481165,5394206,-3913041
2010-12-04,20,mon,9849628,6454994,3394634
2010-12-04,21,mon,1986235,4513221,-2526986
2010-12-04,22,mon,3187918,800490,2387428
2010-12-04,23,mon,9603672,8916596,687076
2010-12-04,0,data,1564792,9512491,-7947699
2010-12-04,1,data,9646107,6300531,3345576
2010-12-04,2,data,608456,1153549,-545093
2010-12-04,3,data,1230727,6457725,-5226998
2010-12-04,4,data,3109522,3906382,-796860
2010-12-04,5,data,9513854,8336132,1177722
2010-12-04,6,data,6217205,2008016,4209189
2010-12-04,7,data,1472122,3760937,-2288815
2010-12-04,8,data,1343427,5117848,-3774421
2010-12-04,9,data,1236605,8785134,-7548529
2010-12-04,10,data,871355,224718,646637
2010-12-04,11,data,3833992,1570739,2263253
2010-12-04,12,data,7220899,3558974,3661925
2010-12-04,13,data,4614160,8422080,-3807920
2010-12-04,14,data,3911630,8994665,-5083035
2010-12-04,15,data,1651318,6877514,-5226196
2010-12-04,16,data,776883,5110919,-4334036
2010-12-04,17,data,8312746,5327221,2985525
2010-12-04,18,data,5004293,8249254,-3244961
2010-12-04,19,data,7703384,2671075,5032309
2010-12-04,20,data,4101951,2778062,1323889
2010-12-04,21,data,4325913,4852382,-526469
2010-12-04,22,data,6194970,3148336,3046634
2010-12-04,23,data,9624225,3811482,5812743
2010-12-04,0,voice,2010857,9080965,-7070108
2010-12-04,1,voice,4845102,3839794,1005308
2010-12-04,2,voice,1340275,3678491,-2338216
2010-12-04,3,voice,409531,6398554,-5989023
2010-12-04,4,voice,3240857,5590794,-2349937
2010-12-04,5,voice,846877,7962336,-7115459
2010-12-04,6,voice,4077863,4712443,-634580
2010-12-04,7,voice,3214553,9955060,-6740507
2010-12-04,8,voice,7250501,3308237,3942264
2010-12-04,9,voice,146952,8341091,-8194139
2010-12-04,10,voice,6226610,8806616,-2580006
2010-12-04,11,voice,2409812,6879194,-4469382
2010-12-04,12,voice,6519091,1123222,5395869
2010-12-04,13,voice,6528694,4999973,1528721
2010-12-04,14,voice,5968406,7160557,-1192151
2010-12-04,15,voice,954459,3221601,-2267142
2010-12-04,16,voice,3567883,987833,2580050
2010-12-04,17,voice,6575436,50910,6524526
2010-12-04,18,voice,6704435,6290620,413815
2010-12-04,19,voice,1387905,1425110,-37205
2010-12-04,20,voice,1287487,4661739,-3374252
2010-12-04,21,voice,8470458,9503349,-1032891
2010-12-04,22,voice,116434,8361653,-8245219
2010-12-04,23,voice,5593912,8418919,-2825007
2010-12-04,0,sms,3340203,6469896,-3129693
2010-12-04,1,sms,8013661,2510890,5502771
2010-12-04,2,sms,726966,1360647,-633681
2010-12-04,3,sms,9946958,1926820,8020138
2010-12-04,4,sms,578016,4824131,-4246115
2010-12-04,5,sms,7512610,6113264,1399346
2010-12-04,6,sms,3366168,7981229,-4615061
2010-12-04,7,sms,7871975,2356225,5515750
2010-12-04,8,sms,4326104,1876966,2449138
2010-12-04,9,sms,9016423,7918769,1097654
2010-12-04,10,sms,4890536,8778763,-3888227
2010-12-04,11,sms,9877832,3140147,6737685
2010-12-04,12,sms,4816851,2005223,2811628
2010-12-04,13,sms,2024107,701491,1322616
2010-12-04,14,sms,4047595,554768,3492827
2010-12-04,15,sms,1609043,548872,1060171
2010-12-04,16,sms,7537224,8230059,-692835
2010-12-04,17,sms,7372898,2567646,4805252
2010-12-04,18,sms,9909119,3948824,5960295
2010-12-04,19,sms,5842502,5364345,478157
2010-12-04,20,sms,2979866,5687191,-2707325
2010-12-04,21,sms,5504095,6427254,-923159
2010-12-04,22,sms,7006239,1809611,5196628
2010-12-04,23,sms,8686760,2066873,6619887
2010-12-04,0,clr,1597781,4862735,-3264954
2010-12-04,1,clr,3810330,2617999,1192331
2010-12-04,2,clr,382072,4689280,-4307208
2010-12-04,3,clr,7732902,7188755,544147
2010-12-04,4,clr,2318299,6811426,-4493127
2010-12-04,5,clr,6314676,1110313,5204363
2010-12-04,6,clr,4557599,1431795,3125804
2010-12-04,7,clr,6602835,9839904,-3237069
2010-12-04,8,clr,1156842,1977583,-820741
2010-12-04,9,clr,6858455,8769926,-1911471
2010-12-04,10,clr,2817575,8773988,-5956413
2010-12-04,11,clr,1004291,3237313,-2233022
2010-12-04,12,clr,8649476,4767567,3881909
2010-12-04,13,clr,5145416,6930291,-1784875
2010-12-04,14,clr,3334206,6511362,-3177156
2010-12-04,15,clr,4173235,9225685,-5052450
2010-12-04,16,clr,5074563,4434880,639683
2010-12-04,17,clr,375580,1578901,-1203321
2010-12-04,18,clr,6065404,9752888,-3687484
2010-12-04,19,clr,3038014,5673879,-2635865
2010-12-04,20,clr,6231,9858450,-9852219
2010-12-04,21,clr,806762,342051,464711
2010-12-04,22,clr,7405303,88268,7317035
2010-12-04,23,clr,5244058,2435932,2808126
2010-12-05,0,com,6862317,4800529,2061788
2010-12-05,1,com,4823476,5980984,-1157508
2010-12-05,2,com,2822348,4626698,-1804350
2010-12-05,3,com,5806229,4143356,1662873
2010-12-05,4,com,7873907,173996,7699911
2010-12-05,5,com,5089562,2278159,2811403
2010-12-05,6,com,8369359,1168195,7201164
2010-12-05,7,com,9937030,4764485,5172545
2010-12-05,8,com,9230134,5426206,3803928
2010-12-05,9,com,7120343,454406,6665937
2010-12-05,10,com,2704284,3278089,-573805
2010-12-05,11,com,4077571,3647432,430139
2010-12-05,12,com,3913381,5538438,-1625057
2010-12-05,13,com,5901579,653716,5247863
2010-12-05,14,com,2969695,5830044,-2860349
2010-12-05,15,com,4979603,6625262,-1645659
2010-12-05,16,com,7295890,6693131,602759
2010-12-05,17,com,3217048,4216313,-999265
2010-12-05,18,com,9484919,1560376,7924543
2010-12-05,19,com,1044672,9698665,-8653993
2010-12-05,20,com,1754506,5479027,-3724521
2010-12-05,21,com,7612616,9839494,-2226878
2010-12-05,22,com,9522429,2402832,7119597
2010-12-05,23,com,7899530,315049,7584481
2010-12-05,0,vou,1228069,6934004,-5705935
2010-12-05,1,vou,7745210,9134694,-1389484
2010-12-05,2,vou,9236866,5902293,3334573
2010-12-05,3,vou,7303831,2961085,4342746
2010-12-05,4,vou,925099,7328633,-6403534
2010-12-05,5,vou,2755162,8072697,-5317535
2010-12-05,6,vou,2476844,6514150,-4037306
2010-12-05,7,vou,8250532,809357,7441175
2010-12-05,8,vou,8158526,9860331,-1701805
2010-12-05,9,vou,7074298,658511,6415787
2010-12-05,10,vou,8707751,8342415,365336
2010-12-05,11,vou,6451755,3774235,2677520
2010-12-05,12,vou,7565908,6187307,1378601
2010-12-05,13,vou,2062955,7427420,-5364465
2010-12-05,14,vou,7921041,7500218,420823
2010-12-05,15,vou,7766285,4796558,2969727
2010-12-05,16,vou,3110380,2643119,467261
2010-12-05,17,vou,4333040,8041659,-3708619
2010-12-05,18,vou,6368388,2306708,4061680
2010-12-05,19,vou,1589637,5250665,-3661028
2010-12-05,20,vou,7114363,3869281,3245082
2010-12-05,21,vou,7882115,2565159,5316956
2010-12-05,22,vou,8233404,5034778,3198626
2010-12-05,23,vou,3238974,3930287,-691313
2010-12-05,0,cm,2924887,6719355,-3794468
2010-12-05,1,cm,653110,1338069,-684959
2010-12-05,2,cm,4548618,5155888,-607270
2010-12-05,3,cm,582444,874487,-292043
2010-12-05,4,cm,5499614,8591240,-3091626
2010-12-05,5,cm,8263344,4280231,3983113
2010-12-05,6,cm,2389772,4260148,-1870376
2010-12-05,7,cm,5998801,1450914,4547887
2010-12-05,8,cm,204357,6224245,-6019888
2010-12-05,9,cm,4566676,4655789,-89113
2010-12-05,10,cm,3217718,5846861,-2629143
2010-12-05,11,cm,532968,1733887,-1200919
2010-12-05,12,cm,2421433,8656904,-6235471
2010-12-05,13,cm,5491280,6755501,-1264221
2010-12-05,14,cm,6727903,5057243,1670660
2010-12-05,15,cm,5139249,1212654,3926595
2010-12-05,16,cm,2652298,9639345,-6987047
2010-12-05,17,cm,9744251,4205297,5538954
2010-12-05,18,cm,8821965,9842908,-1020943
2010-12-05,19,cm,9745709,1850223,7895486
2010-12-05,20,cm,5340192,300290,5039902
2010-12-05,21,cm,4875740,4905090,-29350
2010-12-05,22,cm,1757548,2634525,-876977
2010-12-05,23,cm,1080674,1159043,-78369
2010-12-05,0,adj,782021,9177720,-8395699
2010-12-05,1,adj,2260048,2463145,-203097
2010-12-05,2,adj,3586013,488287,3097726
2010-12-05,3,adj,6373473,99327,6274146
2010-12-05,4,adj,7660578,7956755,-296177
2010-12-05,5,adj,7714677,257887,7456790
2010-12-05,6,adj,1558144,3478620,-1920476
2010-12-05,7,adj,8609104,2027980,6581124
2010-12-05,8,adj,7852244,4371072,3481172
2010-12-05,9,adj,3912424,5666419,-1753995
2010-12-05,10,adj,687523,3971816,-3284293
2010-12-05,11,adj,9660730,9091419,569311
2010-12-05,12,adj,6280791,7955733,-1674942
2010-12-05,13,adj,4923995,5269104,-345109
2010-12-05,14,adj,1474526,4844046,-3369520
2010-12-05,15,adj,3442563,3025199,417364
2010-12-05,16,adj,1828837,226996,1601841
2010-12-05,17,adj,1063847,1974596,-910749
2010-12-05,18,adj,8981852,6919247,2062605
2010-12-05,19,adj,8965067,439808,8525259
2010-12-05,20,adj,5861937,8149378,-2287441
2010-12-05,21,adj,894406,942637,-48231
2010-12-05,22,adj,8481771,6411872,2069899
2010-12-05,23,adj,1143823,7334332,-6190509
2010-12-05,0,first,9444054,4588981,4855073
2010-12-05,1,first,4804648,1672028,3132620
2010-12-05,2,first,8143948,510975,7632973
2010-12-05,3,first,7661404,9907748,-2246344
2010-12-05,4,first,5931082,1534214,4396868
2010-12-05,5,first,1064704,3498180,-2433476
2010-12-05,6,first,505298,8974543,-8469245
2010-12-05,7,first,5571922,861440,4710482
2010-12-05,8,first,6928589,6614127,314462
2010-12-05,9,first,4844918,2589639,2255279
2010-12-05,10,first,6405265,8572096,-2166831
2010-12-05,11,first,2413969,6094246,-3680277
2010-12-05,12,first,4443100,1362082,3081018
2010-12-05,13,first,8621332,635613,7985719
2010-12-05,14,first,7505979,6283777,1222202
2010-12-05,15,first,3999668,5481379,-1481711
2010-12-05,16,first,4078673,4628989,-550316
2010-12-05,17,first,6494288,905093,5589195
2010-12-05,18,first,3340485,4475,3336010
2010-12-05,19,first,6745785,8137105,-1391320
2010-12-05,20,first,5450883,5936270,-485387
2010-12-05,21,first,6340170,2825653,3514517
2010-12-05,22,first,2579909,9660659,-7080750
2010-12-05,23,first,6989223,7982876,-993653
2010-12-05,0,mon,589909,2223188,-1633279
2010-12-05,1,mon,8204505,9272836,-1068331
2010-12-05,2,mon,5828423,6183258,-354835
2010-12-05,3,mon,4029279,4984725,-955446
2010-12-05,4,mon,5958443,6506491,-548048
2010-12-05,5,mon,7524388,62452,7461936
2010-12-05,6,mon,1463218,7517627,-6054409
2010-12-05,7,mon,3524026,4130989,-606963
2010-12-05,8,mon,3256993,7014197,-3757204
2010-12-05,9,mon,6256180,9733826,-3477646
2010-12-05,10,mon,4926117,5952350,-1026233
2010-12-05,11,mon,4588404,2576998,2011406
2010-12-05,12,mon,3844753,7770483,-3925730
2010-12-05,13,mon,3817396,7522948,-3705552
2010-12-05,14,mon,7869268,5093424,2775844
2010-12-05,15,mon,6803339,2688719,4114620
2010-12-05,16,mon,7559027,2136477,5422550
2010-12-05,17,mon,9963313,6899039,3064274
2010-12-05,18,mon,3552183,5414899,-1862716
2010-12-05,19,mon,5968680,526239,5442441
2010-12-05,20,mon,3060022,5156875,-2096853
2010-12-05,21,mon,7176826,3681143,3495683
2010-12-05,22,mon,9579565,3075836,6503729
2010-12-05,23,mon,4385085,3890718,494367
2010-12-05,0,data,2023835,7920035,-5896200
2010-12-05,1,data,1978785,2633846,-655061
2010-12-05,2,data,6904149,1095360,5808789
2010-12-05,3,data,760499,3263243,-2502744
2010-12-05,4,data,9013040,3836588,5176452
2010-12-05,5,data,1169568,8897418,-7727850
2010-12-05,6,data,3745189,3659085,86104
2010-12-05,7,data,4852095,4799882,52213
2010-12-05,8,data,6792666,2474235,4318431
2010-12-05,9,data,4271831,1804510,2467321
2010-12-05,10,data,5004344,3378272,1626072
2010-12-05,11,data,2527748,7102621,-4574873
2010-12-05,12,data,6101890,3042640,3059250
2010-12-05,13,data,5459940,9866507,-4406567
2010-12-05,14,data,227496,6073939,-5846443
2010-12-05,15,data,6611309,6140633,470676
2010-12-05,16,data,8872219,1416769,7455450
2010-12-05,17,data,8635705,9273342,-637637
2010-12-05,18,data,2021106,9214541,-7193435
2010-12-05,19,data,7335733,1378930,5956803
2010-12-05,20,data,2421491,5127481,-2705990
2010-12-05,21,data,6361989,982086,5379903
2010-12-05,22,data,6163517,4709972,1453545
2010-12-05,23,data,4132425,7647751,-3515326
2010-12-05,0,voice,7723347,8592206,-868859
2010-12-05,1,voice,3559684,6802387,-3242703
2010-12-05,2,voice,8720135,8533556,186579
2010-12-05,3,voice,170181,9778321,-9608140
2010-12-05,4,voice,2509030,7380520,-4871490
2010-12-05,5,voice,9386099,137027,9249072
2010-12-05,6,voice,5725090,5161166,563924
2010-12-05,7,voice,3649290,6280577,-2631287
2010-12-05,8,voice,5256805,5990834,-734029
2010-12-05,9,voice,6102633,4429493,1673140
2010-12-05,10,voice,8919918,7789495,1130423
2010-12-05,11,voice,1981022,2140995,-159973
2010-12-05,12,voice,4694118,1614198,3079920
2010-12-05,13,voice,2673898,4988168,-2314270
2010-12-05,14,voice,8991782,2733161,6258621
2010-12-05,15,voice,7325899,5392293,1933606
2010-12-05,16,voice,2431604,4619304,-2187700
2010-12-05,17,voice,1707476,5342738,-3635262
2010-12-05,18,voice,1128360,5539213,-4410853
2010-12-05,19,voice,3693109,4184612,-491503
2010-12-05,20,voice,5542683,2888349,2654334
2010-12-05,21,voice,9067478,6387664,2679814
2010-12-05,22,voice,6107722,715258,5392464
2010-12-05,23,voice,1093786,6314347,-5220561
2010-12-05,0,sms,5535913,2697511,2838402
2010-12-05,1,sms,6691179,1501741,5189438
2010-12-05,2,sms,3580825,499900,3080925
2010-12-05,3,sms,7110742,2390876,4719866
2010-12-05,4,sms,7606536,3474054,4132482
2010-12-05,5,sms,9276203,9993271,-717068
2010-12-05,6,sms,5949997,832143,5117854
2010-12-05,7,sms,424383,7007645,-6583262
2010-12-05,8,sms,2444770,260544,2184226
2010-12-05,9,sms,4315814,4873085,-557271
2010-12-05,10,sms,5610333,9060031,-3449698
2010-12-05,11,sms,3331892,3606187,-274295
2010-12-05,12,sms,5980360,7376258,-1395898
2010-12-05,13,sms,159019,7823926,-7664907
2010-12-05,14,sms,3913577,9696293,-5782716
2010-12-05,15,sms,1095922,904279,191643
2010-12-05,16,sms,6528598,7887367,-1358769
2010-12-05,17,sms,8293917,6998247,1295670
2010-12-05,18,sms,1519539,3470341,-1950802
2010-12-05,19,sms,5910035,4627584,1282451
2010-12-05,20,sms,4767189,7542793,-2775604
2010-12-05,21,sms,2655741,9119910,-6464169
2010-12-05,22,sms,6558844,4051762,2507082
2010-12-05,23,sms,8312093,1522103,6789990
2010-12-05,0,clr,60312,9763896,-9703584
2010-12-05,1,clr,8908908,6636830,2272078
2010-12-05,2,clr,2810526,2127958,682568
2010-12-05,3,clr,5051106,5175133,-124027
2010-12-05,4,clr,1812395,2825489,-1013094
2010-12-05,5,clr,408533,4804674,-4396141
2010-12-05,6,clr,9403124,852124,8551000
2010-12-05,7,clr,4179945,2686649,1493296
2010-12-05,8,clr,6091022,6084819,6203
2010-12-05,9,clr,5730172,3207737,2522435
2010-12-05,10,clr,6605948,799012,5806936
2010-12-05,11,clr,3939912,5154546,-1214634
2010-12-05,12,clr,9117403,1428638,7688765
2010-12-05,13,clr,5981367,8730453,-2749086
2010-12-05,14,clr,8187691,5584847,2602844
2010-12-05,15,clr,5299991,8555841,-3255850
2010-12-05,16,clr,2752213,5442830,-2690617
2010-12-05,17,clr,7007105,5429706,1577399
2010-12-05,18,clr,8727476,5502445,3225031
2010-12-05,19,clr,3305926,7400730,-4094804
2010-12-05,20,clr,728860,2544332,-1815472
2010-12-05,21,clr,8586230,4337855,4248375
2010-12-05,22,clr,5307978,4817268,490710
2010-12-05,23,clr,3595600,3611545,-15945
2010-12-06,0,com,7387258,9823884,-2436626
2010-12-06,1,com,2118592,4941144,-2822552
2010-12-06,2,com,618200,6046217,-5428017
2010-12-06,3,com,537603,6113705,-5576102
2010-12-06,4,com,7271545,4517564,2753981
2010-12-06,5,com,1827407,1480926,346481
2010-12-06,6,com,7676459,5051878,2624581
2010-12-06,7,com,5948940,4289004,1659936
2010-12-06,8,com,1156166,2990936,-1834770
2010-12-06,9,com,5936012,5048995,887017
2010-12-06,10,com,8536331,6045538,2490793
2010-12-06,11,com,267817,3971510,-3703693
2010-12-06,12,com,6721648,191690,6529958
2010-12-06,13,com,6185326,1473320,4712006
2010-12-06,14,com,3009437,5458775,-2449338
2010-12-06,15,com,8192225,6678718,1513507
2010-12-06,16,com,4678529,2878992,1799537
2010-12-06,17,com,8617532,8319312,298220
2010-12-06,18,com,878448,6374181,-5495733
2010-12-06,19,com,7560592,5856954,1703638
2010-12-06,20,com,8904016,6336761,2567255
2010-12-06,21,com,2916108,9321089,-6404981
2010-12-06,22,com,8217526,7749670,467856
2010-12-06,23,com,3745531,366629,3378902
2010-12-06,0,vou,637040,1777614,-1140574
2010-12-06,1,vou,3066015,4937607,-1871592
2010-12-06,2,vou,6576739,4501701,2075038
2010-12-06,3,vou,1839055,7292216,-5453161
2010-12-06,4,vou,1404135,9520106,-8115971
2010-12-06,5,vou,3478431,5665788,-2187357
2010-12-06,6,vou,5706081,6696327,-990246
2010-12-06,7,vou,9499916,2792484,6707432
2010-12-06,8,vou,6784585,4459727,2324858
2010-12-06,9,vou,4829799,7089852,-2260053
2010-12-06,10,vou,6766928,2022339,4744589
2010-12-06,11,vou,5976144,9868104,-3891960
2010-12-06,12,vou,5461663,7528217,-2066554
2010-12-06,13,vou,2785464,1827351,958113
2010-12-06,14,vou,9403012,1614870,7788142
2010-12-06,15,vou,9227041,2432778,6794263
2010-12-06,16,vou,754476,3574435,-2819959
2010-12-06,17,vou,4142559,8146130,-4003571
2010-12-06,18,vou,7053243,5683228,1370015
2010-12-06,19,vou,3750194,8433846,-4683652
2010-12-06,20,vou,5989229,6425164,-435935
2010-12-06,21,vou,4225413,7367288,-3141875
2010-12-06,22,vou,5108014,5821473,-713459
2010-12-06,23,vou,2111646,7293874,-5182228
2010-12-06,0,cm,5114241,8678915,-3564674
2010-12-06,1,cm,7142773,9475560,-2332787
2010-12-06,2,cm,1399165,4226576,-2827411
2010-12-06,3,cm,8191139,3507908,4683231
2010-12-06,4,cm,5597583,7633661,-2036078
2010-12-06,5,cm,3690489,6103462,-2412973
2010-12-06,6,cm,3261551,427546,2834005
2010-12-06,7,cm,6214115,4038857,2175258
2010-12-06,8,cm,2530293,723231,1807062
2010-12-06,9,cm,5977732,6535330,-557598
2010-12-06,10,cm,8175555,807456,7368099
2010-12-06,11,cm,8306821,5996363,2310458
2010-12-06,12,cm,7867753,7268963,598790
2010-12-06,13,cm,6622780,749545,5873235
2010-12-06,14,cm,6739713,7880516,-1140803
2010-12-06,15,cm,317698,4357769,-4040071
2010-12-06,16,cm,7011265,6479592,531673
2010-12-06,17,cm,9537551,5672239,3865312
2010-12-06,18,cm,571656,769879,-198223
2010-12-06,19,cm,9681514,3287944,6393570
2010-12-06,20,cm,8396051,9666856,-1270805
2010-12-06,21,cm,7365680,1076732,6288948
2010-12-06,22,cm,1440162,160080,1280082
2010-12-06,23,cm,8101294,7594311,506983
2010-12-06,0,adj,8952083,9313701,-361618
2010-12-06,1,adj,1115340,8418604,-7303264
2010-12-06,2,adj,8007440,1081106,6926334
2010-12-06,3,adj,4632310,5841796,-1209486
2010-12-06,4,adj,2093336,3199946,-1106610
2010-12-06,5,adj,3112365,703851,2408514
2010-12-06,6,adj,4152413,3745922,406491
2010-12-06,7,adj,1849282,2170800,-321518
2010-12-06,8,adj,285043,9323338,-9038295
2010-12-06,9,adj,3336977,1064571,2272406
2010-12-06,10,adj,3026536,1310930,1715606
2010-12-06,11,adj,3336305,1774066,1562239
2010-12-06,12,adj,4612095,1963442,2648653
2010-12-06,13,adj,5574399,7853941,-2279542
2010-12-06,14,adj,2242883,484545,1758338
2010-12-06,15,adj,1147092,1288113,-141021
2010-12-06,16,adj,1778271,5243606,-3465335
2010-12-06,17,adj,7397056,2918845,4478211
2010-12-06,18,adj,2318198,7402628,-5084430
2010-12-06,19,adj,5333364,5455849,-122485
2010-12-06,20,adj,6412559,9475892,-3063333
2010-12-06,21,adj,3524865,2746465,778400
2010-12-06,22,adj,1541973,7389951,-5847978
2010-12-06,23,adj,3746951,2380516,1366435
2010-12-06,0,first,6768379,4614203,2154176
2010-12-06,1,first,6799968,8347828,-1547860
2010-12-06,2,first,3868949,7064892,-3195943
2010-12-06,3,first,3429253,6878253,-3449000
2010-12-06,4,first,6930738,6141974,788764
2010-12-06,5,first,3695086,9405318,-5710232
2010-12-06,6,first,4218431,8857349,-4638918
2010-12-06,7,first,20498,9422199,-9401701
2010-12-06,8,first,4583374,6833728,-2250354
2010-12-06,9,first,4939833,8542329,-3602496
2010-12-06,10,first,5373921,8239979,-2866058
2010-12-06,11,first,6599390,3172452,3426938
2010-12-06,12,first,3166523,529553,2636970
2010-12-06,13,first,2736535,6862686,-4126151
2010-12-06,14,first,3408110,7402097,-3993987
2010-12-06,15,first,7870126,3499018,4371108
2010-12-06,16,first,2453408,3085580,-632172
2010-12-06,17,first,9979637,6422300,3557337
2010-12-06,18,first,2583955,4426987,-1843032
2010-12-06,19,first,7086905,1559173,5527732
2010-12-06,20,first,2730809,9657724,-6926915
2010-12-06,21,first,8427924,9497443,-1069519
2010-12-06,22,first,1974318,4418427,-2444109
2010-12-06,23,first,5339258,7859836,-2520578
2010-12-06,0,mon,5588861,998161,4590700
2010-12-06,1,mon,8301377,1524186,6777191
2010-12-06,2,mon,1471478,2937690,-1466212
2010-12-06,3,mon,2799163,7515400,-4716237
2010-12-06,4,mon,4403210,7591914,-3188704
2010-12-06,5,mon,1374606,7681792,-6307186
2010-12-06,6,mon,1223037,2953743,-1730706
2010-12-06,7,mon,9005407,4248514,4756893
2010-12-06,8,mon,7352538,4640431,2712107
2010-12-06,9,mon,8972679,7963339,1009340
2010-12-06,10,mon,3191831,6212620,-3020789
2010-12-06,11,mon,1747096,5942137,-4195041
2010-12-06,12,mon,3363338,1416793,1946545
2010-12-06,13,mon,5724660,4989411,735249
2010-12-06,14,mon,1738672,3027535,-1288863
2010-12-06,15,mon,968284,5072349,-4104065
2010-12-06,16,mon,4290097,6960523,-2670426
2010-12-06,17,mon,6596070,9950199,-3354129
2010-12-06,18,mon,3634378,971304,2663074
2010-12-06,19,mon,3359207,5817569,-2458362
2010-12-06,20,mon,167037,3700445,-3533408
2010-12-06,21,mon,4191061,7664160,-3473099
2010-12-06,22,mon,4333855,4749062,-415207
2010-12-06,23,mon,9463216,8656914,806302
2010-12-06,0,data,6719231,8957563,-2238332
2010-12-06,1,data,3715036,4270867,-555831
2010-12-06,2,data,4186847,1755491,2431356
2010-12-06,3,data,8048564,8462736,-414172
2010-12-06,4,data,8047350,549108,7498242
2010-12-06,5,data,1397973,4792009,-3394036
2010-12-06,6,data,4132805,9736839,-5604034
2010-12-06,7,data,6084729,6094791,-10062
2010-12-06,8,data,8361728,4306208,4055520
2010-12-06,9,data,674426,1126211,-451785
2010-12-06,10,data,2725611,2060328,665283
2010-12-06,11,data,3117756,1750762,1366994
2010-12-06,12,data,791682,5504717,-4713035
2010-12-06,13,data,5422159,382689,5039470
2010-12-06,14,data,9099052,6824956,2274096
2010-12-06,15,data,2605298,3755662,-1150364
2010-12-06,16,data,3152655,8262006,-5109351
2010-12-06,17,data,3728091,73650,3654441
2010-12-06,18,data,8068109,2108191,5959918
2010-12-06,19,data,8646478,1851834,6794644
2010-12-06,20,data,4702867,1203556,3499311
2010-12-06,21,data,2826103,1188657,1637446
2010-12-06,22,data,3290571,5698873,-2408302
2010-12-06,23,data,4283395,2865061,1418334
2010-12-06,0,voice,4273990,5564986,-1290996
2010-12-06,1,voice,8411330,4866819,3544511
2010-12-06,2,voice,7931950,9166227,-1234277
2010-12-06,3,voice,6707113,1608608,5098505
2010-12-06,4,voice,3948412,3748812,199600
2010-12-06,5,voice,9375575,3606916,5768659
2010-12-06,6,voice,8247898,5311225,2936673
2010-12-06,7,voice,4479339,8475411,-3996072
2010-12-06,8,voice,6671297,324154,6347143
2010-12-06,9,voice,756221,7206218,-6449997
2010-12-06,10,voice,6803422,809357,5994065
2010-12-06,11,voice,9944608,2769072,7175536
2010-12-06,12,voice,8758120,3804313,4953807
2010-12-06,13,voice,1837275,8276837,-6439562
2010-12-06,14,voice,8324826,5623192,2701634
2010-12-06,15,voice,2379722,8013467,-5633745
2010-12-06,16,voice,3669753,3343876,325877
2010-12-06,17,voice,1530613,1056605,474008
2010-12-06,18,voice,573613,2035592,-1461979
2010-12-06,19,voice,8122909,577807,7545102
2010-12-06,20,voice,6520740,4663920,1856820
2010-12-06,21,voice,9404649,9672179,-267530
2010-12-06,22,voice,643114,8608326,-7965212
2010-12-06,23,voice,9599583,5534905,4064678
2010-12-06,0,sms,1970112,5746285,-3776173
2010-12-06,1,sms,7583579,1261595,6321984
2010-12-06,2,sms,3172275,92710,3079565
2010-12-06,3,sms,2334306,7371018,-5036712
2010-12-06,4,sms,3945676,1380909,2564767
2010-12-06,5,sms,3392817,9259399,-5866582
2010-12-06,6,sms,7575787,7278710,297077
2010-12-06,7,sms,6429619,4260369,2169250
2010-12-06,8,sms,2588105,7115260,-4527155
2010-12-06,9,sms,2336284,8369449,-6033165
2010-12-06,10,sms,1583798,438166,1145632
2010-12-06,11,sms,4860365,5697606,-837241
2010-12-06,12,sms,6472121,9578725,-3106604
2010-12-06,13,sms,761779,26923,734856
2010-12-06,14,sms,643596,252907,390689
2010-12-06,15,sms,1864616,7406497,-5541881
2010-12-06,16,sms,2744029,3208937,-464908
2010-12-06,17,sms,3391402,1418035,1973367
2010-12-06,18,sms,4212391,3792114,420277
2010-12-06,19,sms,8400388,9224452,-824064
2010-12-06,20,sms,9653136,8088544,1564592
2010-12-06,21,sms,6668101,5256203,1411898
2010-12-06,22,sms,5393929,9346770,-3952841
2010-12-06,23,sms,117487,831530,-714043
2010-12-06,0,clr,8421089,4888295,3532794
2010-12-06,1,clr,5838065,5555426,282639
2010-12-06,2,clr,4225809,2863638,1362171
2010-12-06,3,clr,5358503,2448660,2909843
2010-12-06,4,clr,794628,4629982,-3835354
2010-12-06,5,clr,7760416,53304,7707112
2010-12-06,6,clr,1233748,5229264,-3995516
2010-12-06,7,clr,8971173,1887787,7083386
2010-12-06,8,clr,2839012,5588749,-2749737
2010-12-06,9,clr,3808334,7981736,-4173402
2010-12-06,10,clr,4593339,9375478,-4782139
2010-12-06,11,clr,2171217,630751,1540466
2010-12-06,12,clr,8347793,6268136,2079657
2010-12-06,13,clr,4096884,2267041,1829843
2010-12-06,14,clr,1112328,7450084,-6337756
2010-12-06,15,clr,2339860,5643671,-3303811
2010-12-06,16,clr,9851137,4443213,5407924
2010-12-06,17,clr,1406215,8133845,-6727630
2010-12-06,18,clr,9850705,7584994,2265711
2010-12-06,19,clr,6978803,1452268,5526535
2010-12-06,20,clr,9727707,892858,8834849
2010-12-06,21,clr,1401811,4235516,-2833705
2010-12-06,22,clr,9873536,9077663,795873
2010-12-06,23,clr,6494457,5519349,975108
2010-12-07,0,com,2316523,8960888,-6644365
2010-12-07,1,com,9439564,3538249,5901315
2010-12-07,2,com,2061369,6986547,-4925178
2010-12-07,3,com,6619038,4262824,2356214
2010-12-07,4,com,3710025,2367337,1342688
2010-12-07,5,com,6238984,4795229,1443755
2010-12-07,6,com,1410398,4638406,-3228008
2010-12-07,7,com,5643594,4800378,843216
2010-12-07,8,com,2477658,3622397,-1144739
2010-12-07,9,com,3234488,1625385,1609103
2010-12-07,10,com,3633954,9189243,-5555289
2010-12-07,11,com,8213022,1466399,6746623
2010-12-07,12,com,1602887,4163211,-2560324
2010-12-07,13,com,5028960,9411798,-4382838
2010-12-07,14,com,4403377,1792748,2610629
2010-12-07,15,com,7513337,4143444,3369893
2010-12-07,16,com,5579466,795943,4783523
2010-12-07,17,com,4975602,6756536,-1780934
2010-12-07,18,com,9689474,1656741,8032733
2010-12-07,19,com,3018129,9347842,-6329713
2010-12-07,20,com,9489806,4014216,5475590
2010-12-07,21,com,2176494,5341934,-3165440
2010-12-07,22,com,2062637,6353589,-4290952
2010-12-07,23,com,958287,4730338,-3772051
2010-12-07,0,vou,6102581,2972843,3129738
2010-12-07,1,vou,5819625,3205095,2614530
2010-12-07,2,vou,9075582,374731,8700851
2010-12-07,3,vou,1275387,6187796,-4912409
2010-12-07,4,vou,6518816,9450879,-2932063
2010-12-07,5,vou,7857951,443754,7414197
2010-12-07,6,vou,9746333,3652973,6093360
2010-12-07,7,vou,8689983,2688104,6001879
2010-12-07,8,vou,2218,7037229,-7035011
2010-12-07,9,vou,7140293,854036,6286257
2010-12-07,10,vou,4522632,8505301,-3982669
2010-12-07,11,vou,3853400,1497145,2356255
2010-12-07,12,vou,3652947,3646576,6371
2010-12-07,13,vou,5418248,3597575,1820673
2010-12-07,14,vou,750573,5785505,-5034932
2010-12-07,15,vou,123616,7788132,-7664516
2010-12-07,16,vou,8268831,2106855,6161976
2010-12-07,17,vou,8891116,653116,8238000
2010-12-07,18,vou,9375227,8759613,615614
2010-12-07,19,vou,4473317,5666926,-1193609
2010-12-07,20,vou,9893999,1207309,8686690
2010-12-07,21,vou,6132626,832596,5300030
2010-12-07,22,vou,9066340,4025132,5041208
2010-12-07,23,vou,1090044,9822056,-8732012
2010-12-07,0,cm,7351033,3359036,3991997
2010-12-07,1,cm,7505672,4332735,3172937
2010-12-07,2,cm,1751289,1935771,-184482
2010-12-07,3,cm,11875,9300635,-9288760
2010-12-07,4,cm,2064641,1967387,97254
2010-12-07,5,cm,2688542,6985263,-4296721
2010-12-07,6,cm,9893493,4953627,4939866
2010-12-07,7,cm,3425753,8332601,-4906848
2010-12-07,8,cm,6949614,2502412,4447202
2010-12-07,9,cm,6422569,2112032,4310537
2010-12-07,10,cm,7709482,9653052,-1943570
2010-12-07,11,cm,4959402,3974850,984552
2010-12-07,12,cm,3354541,5937113,-2582572
2010-12-07,13,cm,5661964,1295306,4366658
2010-12-07,14,cm,6287783,7046719,-758936
2010-12-07,15,cm,7636755,9483524,-1846769
2010-12-07,16,cm,8916807,5822489,3094318
2010-12-07,17,cm,9921728,3962640,5959088
2010-12-07,18,cm,6389556,9689690,-3300134
2010-12-07,19,cm,9961185,6359452,3601733
2010-12-07,20,cm,5213808,2373957,2839851
2010-12-07,21,cm,3217013,550379,2666634
2010-12-07,22,cm,27152,5928388,-5901236
2010-12-07,23,cm,4938891,9010031,-4071140
2010-12-07,0,adj,7561872,1355641,6206231
2010-12-07,1,adj,9769144,7094669,2674475
2010-12-07,2,adj,7404405,9689839,-2285434
2010-12-07,3,adj,1752159,7712419,-5960260
2010-12-07,4,adj,4698877,1846524,2852353
2010-12-07,5,adj,9293861,2082723,7211138
2010-12-07,6,adj,5079631,3341953,1737678
2010-12-07,7,adj,1446890,7056241,-5609351
2010-12-07,8,adj,651464,3376785,-2725321
2010-12-07,9,adj,5171944,6784071,-1612127
2010-12-07,10,adj,1295174,868763,426411
2010-12-07,11,adj,6748638,2977386,3771252
2010-12-07,12,adj,5097248,176979,4920269
2010-12-07,13,adj,1113313,3145673,-2032360
2010-12-07,14,adj,7834852,4622671,3212181
2010-12-07,15,adj,4435097,3204690,1230407
2010-12-07,16,adj,3993841,4893997,-900156
2010-12-07,17,adj,458909,9902039,-9443130
2010-12-07,18,adj,6007253,6080504,-73251
2010-12-07,19,adj,5708068,9978240,-4270172
2010-12-07,20,adj,5125988,7566548,-2440560
2010-12-07,21,adj,3664449,4412909,-748460
2010-12-07,22,adj,9127698,8963721,163977
2010-12-07,23,adj,4736597,3188496,1548101
2010-12-07,0,first,8543851,9443194,-899343
2010-12-07,1,first,1769316,4186482,-2417166
2010-12-07,2,first,8160257,5246222,2914035
2010-12-07,3,first,8944519,7759798,1184721
2010-12-07,4,first,2378302,8265173,-5886871
2010-12-07,5,first,4393809,7575769,-3181960
2010-12-07,6,first,6201416,7458740,-1257324
2010-12-07,7,first,8419460,446723,7972737
2010-12-07,8,first,1249792,6614438,-5364646
2010-12-07,9,first,2905353,226509,2678844
2010-12-07,10,first,2892331,6150799,-3258468
2010-12-07,11,first,3777601,2186323,1591278
2010-12-07,12,first,6553267,3569726,2983541
2010-12-07,13,first,7105340,5042062,2063278
2010-12-07,14,first,4810635,1771695,3038940
2010-12-07,15,first,6065254,6249727,-184473
2010-12-07,16,first,1621587,2865850,-1244263
2010-12-07,17,first,7537229,5499460,2037769
2010-12-07,18,first,3874369,6311528,-2437159
2010-12-07,19,first,2772739,2570616,202123
2010-12-07,20,first,4387260,3426891,960369
2010-12-07,21,first,3605664,5364155,-1758491
2010-12-07,22,first,1545738,4325464,-2779726
2010-12-07,23,first,4178951,1960910,2218041
2010-12-07,0,mon,5223976,8435289,-3211313
2010-12-07,1,mon,9385386,3246893,6138493
2010-12-07,2,mon,7572305,8849881,-1277576
2010-12-07,3,mon,4426297,1918188,2508109
2010-12-07,4,mon,1145117,2583326,-1438209
2010-12-07,5,mon,5099954,5843708,-743754
2010-12-07,6,mon,2816312,577914,2238398
2010-12-07,7,mon,5231341,2925292,2306049
2010-12-07,8,mon,763536,6047837,-5284301
2010-12-07,9,mon,9932982,8903372,1029610
2010-12-07,10,mon,4662325,3053774,1608551
2010-12-07,11,mon,5746216,1113762,4632454
2010-12-07,12,mon,8252155,5463938,2788217
2010-12-07,13,mon,3906590,9306325,-5399735
2010-12-07,14,mon,8464013,8695274,-231261
2010-12-07,15,mon,5505550,3861078,1644472
2010-12-07,16,mon,2889600,8490882,-5601282
2010-12-07,17,mon,6590883,7476971,-886088
2010-12-07,18,mon,2034845,4623177,-2588332
2010-12-07,19,mon,856746,4323853,-3467107
2010-12-07,20,mon,9113163,1434993,7678170
2010-12-07,21,mon,5754199,4398703,1355496
2010-12-07,22,mon,7993563,9503677,-1510114
2010-12-07,23,mon,9867179,7252157,2615022
2010-12-07,0,data,7153184,2338990,4814194
2010-12-07,1,data,6550938,8558115,-2007177
2010-12-07,2,data,1451852,6795313,-5343461
2010-12-07,3,data,9405604,6178276,3227328
2010-12-07,4,data,3878843,7367657,-3488814
2010-12-07,5,data,4892694,1622066,3270628
2010-12-07,6,data,242433,6514517,-6272084
2010-12-07,7,data,7235436,6249213,986223
2010-12-07,8,data,3168518,5741012,-2572494
2010-12-07,9,data,6444563,7669846,-1225283
2010-12-07,10,data,9629149,47445,9581704
2010-12-07,11,data,3836320,1470136,2366184
2010-12-07,12,data,2004470,229479,1774991
2010-12-07,13,data,711952,6686381,-5974429
2010-12-07,14,data,6126541,2254374,3872167
2010-12-07,15,data,4814795,8725873,-3911078
2010-12-07,16,data,1842633,2688744,-846111
2010-12-07,17,data,4058343,3026160,1032183
2010-12-07,18,data,8275538,4101889,4173649
2010-12-07,19,data,8855788,5264171,3591617
2010-12-07,20,data,1613031,1672740,-59709
2010-12-07,21,data,1224500,5777882,-4553382
2010-12-07,22,data,7214203,3912187,3302016
2010-12-07,23,data,4696152,4364616,331536
2010-12-07,0,voice,8813015,4848388,3964627
2010-12-07,1,voice,7275537,7685732,-410195
2010-12-07,2,voice,3394857,7174486,-3779629
2010-12-07,3,voice,9704386,1097056,8607330
2010-12-07,4,voice,8554205,4627432,3926773
2010-12-07,5,voice,3000682,443406,2557276
2010-12-07,6,voice,9624051,7631739,1992312
2010-12-07,7,voice,4819726,3401928,1417798
2010-12-07,8,voice,6898494,7492671,-594177
2010-12-07,9,voice,5114850,5979753,-864903
2010-12-07,10,voice,502298,4621070,-4118772
2010-12-07,11,voice,1471681,9957013,-8485332
2010-12-07,12,voice,5622235,365794,5256441
2010-12-07,13,voice,8864968,1499087,7365881
2010-12-07,14,voice,1638399,598408,1039991
2010-12-07,15,voice,6977926,6512594,465332
2010-12-07,16,voice,9927813,453006,9474807
2010-12-07,17,voice,5007413,7761147,-2753734
2010-12-07,18,voice,6998630,4089018,2909612
2010-12-07,19,voice,6588610,897251,5691359
2010-12-07,20,voice,1294722,5321154,-4026432
2010-12-07,21,voice,3531613,4548735,-1017122
2010-12-07,22,voice,6232086,1720266,4511820
2010-12-07,23,voice,6612592,6180095,432497
2010-12-07,0,sms,371248,2348800,-1977552
2010-12-07,1,sms,8125123,9649811,-1524688
2010-12-07,2,sms,5639535,5181515,458020
2010-12-07,3,sms,5596911,3159874,2437037
2010-12-07,4,sms,221742,5905492,-5683750
2010-12-07,5,sms,3316467,4851518,-1535051
2010-12-07,6,sms,2973839,4392132,-1418293
2010-12-07,7,sms,1539063,7574628,-6035565
2010-12-07,8,sms,3181783,4506953,-1325170
2010-12-07,9,sms,318764,3887081,-3568317
2010-12-07,10,sms,3193225,9543584,-6350359
2010-12-07,11,sms,3754569,2787630,966939
2010-12-07,12,sms,2287108,258390,2028718
2010-12-07,13,sms,6160133,5071463,1088670
2010-12-07,14,sms,9840712,1453943,8386769
2010-12-07,15,sms,2176249,7568827,-5392578
2010-12-07,16,sms,5374501,9496911,-4122410
2010-12-07,17,sms,484577,5503652,-5019075
2010-12-07,18,sms,4399497,4502805,-103308
2010-12-07,19,sms,4887190,8986921,-4099731
2010-12-07,20,sms,7179711,2145104,5034607
2010-12-07,21,sms,6075731,8823279,-2747548
2010-12-07,22,sms,5586161,5712068,-125907
2010-12-07,23,sms,4594894,8875741,-4280847
2010-12-07,0,clr,6243088,8814065,-2570977
2010-12-07,1,clr,9404078,5547059,3857019
2010-12-07,2,clr,2312485,753520,1558965
2010-12-07,3,clr,2682530,2332189,350341
2010-12-07,4,clr,7289504,5547562,1741942
2010-12-07,5,clr,3056942,8121961,-5065019
2010-12-07,6,clr,2816966,4503627,-1686661
2010-12-07,7,clr,6091203,4422884,1668319
2010-12-07,8,clr,739667,9678833,-8939166
2010-12-07,9,clr,97104,2062827,-1965723
2010-12-07,10,clr,5500671,2726443,2774228
2010-12-07,11,clr,3975350,6678257,-2702907
2010-12-07,12,clr,4242177,8294678,-4052501
2010-12-07,13,clr,6182364,3823331,2359033
2010-12-07,14,clr,2697526,228320,2469206
2010-12-07,15,clr,5899236,4903167,996069
2010-12-07,16,clr,9731823,6061380,3670443
2010-12-07,17,clr,5992259,853248,5139011
2010-12-07,18,clr,330369,5141816,-4811447
2010-12-07,19,clr,8993569,7938840,1054729
2010-12-07,20,clr,6483618,9516267,-3032649
2010-12-07,21,clr,8276783,8455078,-178295
2010-12-07,22,clr,2971694,3088780,-117086
2010-12-07,23,clr,6690279,3977849,2712430
2010-12-08,0,com,4723178,4148858,574320
2010-12-08,1,com,6516711,4239852,2276859
2010-12-08,2,com,3875595,7029204,-3153609
2010-12-08,3,com,235716,5641704,-5405988
2010-12-08,4,com,526376,3833748,-3307372
2010-12-08,5,com,7220662,4375303,2845359
2010-12-08,6,com,9687203,2389608,7297595
2010-12-08,7,com,9967704,3384982,6582722
2010-12-08,8,com,6771421,5109235,1662186
2010-12-08,9,com,2243737,1893803,349934
2010-12-08,10,com,9009662,9406404,-396742
2010-12-08,11,com,4767398,6868938,-2101540
2010-12-08,12,com,8433238,2576768,5856470
2010-12-08,13,com,910397,6671992,-5761595
2010-12-08,14,com,7491985,4059114,3432871
2010-12-08,15,com,9008427,9827968,-819541
2010-12-08,16,com,9820452,9814950,5502
2010-12-08,17,com,2196992,9023677,-6826685
2010-12-08,18,com,7230246,4697070,2533176
2010-12-08,19,com,7364333,4538872,2825461
2010-12-08,20,com,2499943,6396347,-3896404
2010-12-08,21,com,7613935,5277552,2336383
2010-12-08,22,com,821546,8071595,-7250049
2010-12-08,23,com,5839728,985097,4854631
2010-12-08,0,vou,737172,5407525,-4670353
2010-12-08,1,vou,3811527,2584678,1226849
2010-12-08,2,vou,1308976,5418082,-4109106
2010-12-08,3,vou,8203861,886277,7317584
2010-12-08,4,vou,9996041,2873577,7122464
2010-12-08,5,vou,4363997,164039,4199958
2010-12-08,6,vou,7420765,9688834,-2268069
2010-12-08,7,vou,184740,1058720,-873980
2010-12-08,8,vou,2985041,8975937,-5990896
2010-12-08,9,vou,3334385,7305509,-3971124
2010-12-08,10,vou,9169680,7862238,1307442
2010-12-08,11,vou,8221147,9742250,-1521103
2010-12-08,12,vou,8215298,4082874,4132424
2010-12-08,13,vou,7598733,3386132,4212601
2010-12-08,14,vou,2652993,1070241,1582752
2010-12-08,15,vou,8722731,9369473,-646742
2010-12-08,16,vou,1795888,8282282,-6486394
2010-12-08,17,vou,7172526,6447439,725087
2010-12-08,18,vou,5283088,6465984,-1182896
2010-12-08,19,vou,4298094,3827450,470644
2010-12-08,20,vou,5809025,2182673,3626352
2010-12-08,21,vou,6617601,9640111,-3022510
2010-12-08,22,vou,4564746,5616990,-1052244
2010-12-08,23,vou,1276640,3849977,-2573337
2010-12-08,0,cm,3113835,125384,2988451
2010-12-08,1,cm,4835044,2482361,2352683
2010-12-08,2,cm,7092603,394583,6698020
2010-12-08,3,cm,34817,5532789,-5497972
2010-12-08,4,cm,2119064,6428648,-4309584
2010-12-08,5,cm,3043378,747572,2295806
2010-12-08,6,cm,7990050,6540878,1449172
2010-12-08,7,cm,6812479,8492422,-1679943
2010-12-08,8,cm,4778516,4317532,460984
2010-12-08,9,cm,3305409,8285890,-4980481
2010-12-08,10,cm,1380630,1441404,-60774
2010-12-08,11,cm,2215045,1488441,726604
2010-12-08,12,cm,6088814,5413253,675561
2010-12-08,13,cm,5333651,5657186,-323535
2010-12-08,14,cm,266647,6504860,-6238213
2010-12-08,15,cm,3036481,5787879,-2751398
2010-12-08,16,cm,2237527,8165645,-5928118
2010-12-08,17,cm,1855429,4410913,-2555484
2010-12-08,18,cm,8332657,3142771,5189886
2010-12-08,19,cm,1826494,1543094,283400
2010-12-08,20,cm,9133173,8183007,950166
2010-12-08,21,cm,4810693,3680553,1130140
2010-12-08,22,cm,9225974,8956847,269127
2010-12-08,23,cm,9808198,7307042,2501156
2010-12-08,0,adj,713916,3497863,-2783947
2010-12-08,1,adj,6799767,4298357,2501410
2010-12-08,2,adj,5728196,4189583,1538613
2010-12-08,3,adj,9786037,2115206,7670831
2010-12-08,4,adj,5368539,1873063,3495476
2010-12-08,5,adj,3123879,9484688,-6360809
2010-12-08,6,adj,710251,5971715,-5261464
2010-12-08,7,adj,7087211,7008037,79174
2010-12-08,8,adj,3144414,4048952,-904538
2010-12-08,9,adj,3257617,4367714,-1110097
2010-12-08,10,adj,4495931,9881601,-5385670
2010-12-08,11,adj,4089852,5428634,-1338782
2010-12-08,12,adj,5403148,4262840,1140308
2010-12-08,13,adj,3017798,695285,2322513
2010-12-08,14,adj,3619737,9160191,-5540454
2010-12-08,15,adj,1555954,6790039,-5234085
2010-12-08,16,adj,6779062,2833240,3945822
2010-12-08,17,adj,839147,5098768,-4259621
2010-12-08,18,adj,6052122,8336821,-2284699
2010-12-08,19,adj,4382343,158740,4223603
2010-12-08,20,adj,3228540,6813660,-3585120
2010-12-08,21,adj,1949960,5884888,-3934928
2010-12-08,22,adj,3648688,6919552,-3270864
2010-12-08,23,adj,6262814,427959,5834855
2010-12-08,0,first,3164751,3602629,-437878
2010-12-08,1,first,8371559,4829662,3541897
2010-12-08,2,first,5558049,256216,5301833
2010-12-08,3,first,445278,3685379,-3240101
2010-12-08,4,first,6413021,5851094,561927
2010-12-08,5,first,1071541,7158818,-6087277
2010-12-08,6,first,2414903,6033797,-3618894
2010-12-08,7,first,8474813,8120036,354777
2010-12-08,8,first,4998412,3725147,1273265
2010-12-08,9,first,3133394,7790357,-4656963
2010-12-08,10,first,6006104,5503146,502958
2010-12-08,11,first,3308389,2146821,1161568
2010-12-08,12,first,2059304,573159,1486145
2010-12-08,13,first,7428572,4441862,2986710
2010-12-08,14,first,203700,751185,-547485
2010-12-08,15,first,4905679,93209,4812470
2010-12-08,16,first,5178295,1826178,3352117
2010-12-08,17,first,9268077,8578344,689733
2010-12-08,18,first,2955083,7758402,-4803319
2010-12-08,19,first,3040973,6850716,-3809743
2010-12-08,20,first,6135411,1467967,4667444
2010-12-08,21,first,3749522,9887079,-6137557
2010-12-08,22,first,5179982,6468300,-1288318
2010-12-08,23,first,5421103,281101,5140002
2010-12-08,0,mon,9622807,8391341,1231466
2010-12-08,1,mon,9557729,9904412,-346683
2010-12-08,2,mon,8636441,605024,8031417
2010-12-08,3,mon,858264,7635125,-6776861
2010-12-08,4,mon,5571296,8951857,-3380561
2010-12-08,5,mon,2021959,8464202,-6442243
2010-12-08,6,mon,1198701,6450299,-5251598
2010-12-08,7,mon,3652139,8309690,-4657551
2010-12-08,8,mon,9797874,1672971,8124903
2010-12-08,9,mon,2054730,3022533,-967803
2010-12-08,10,mon,1510933,7921488,-6410555
2010-12-08,11,mon,4884334,101971,4782363
2010-12-08,12,mon,1936660,5012812,-3076152
2010-12-08,13,mon,7162548,5317100,1845448
2010-12-08,14,mon,2942406,16560,2925846
2010-12-08,15,mon,8073265,781163,7292102
2010-12-08,16,mon,2904184,3802447,-898263
2010-12-08,17,mon,7059059,8613695,-1554636
2010-12-08,18,mon,184628,6009546,-5824918
2010-12-08,19,mon,4021779,8082936,-4061157
2010-12-08,20,mon,5230242,8495610,-3265368
2010-12-08,21,mon,747515,3494399,-2746884
2010-12-08,22,mon,5998795,6453884,-455089
2010-12-08,23,mon,632174,128229,503945
2010-12-08,0,data,3726223,9447584,-5721361
2010-12-08,1,data,607886,3973504,-3365618
2010-12-08,2,data,8151848,153476,7998372
2010-12-08,3,data,5003510,6594414,-1590904
2010-12-08,4,data,951630,9161259,-8209629
2010-12-08,5,data,8070299,645047,7425252
2010-12-08,6,data,9622284,7914219,1708065
2010-12-08,7,data,4378845,4324842,54003
2010-12-08,8,data,1635836,6890707,-5254871
2010-12-08,9,data,3088102,1526584,1561518
2010-12-08,10,data,4382835,9971989,-5589154
2010-12-08,11,data,8372221,504908,7867313
2010-12-08,12,data,9487544,371621,9115923
2010-12-08,13,data,8523906,1301902,7222004
2010-12-08,14,data,9114114,9579285,-465171
2010-12-08,15,data,8200239,716566,7483673
2010-12-08,16,data,2703759,5810622,-3106863
2010-12-08,17,data,2898017,7495694,-4597677
2010-12-08,18,data,9448227,6807532,2640695
2010-12-08,19,data,4709898,9720507,-5010609
2010-12-08,20,data,5675240,5903684,-228444
2010-12-08,21,data,3642976,5326946,-1683970
2010-12-08,22,data,529556,2282048,-1752492
2010-12-08,23,data,3841332,5078666,-1237334
2010-12-08,0,voice,1449290,4326878,-2877588
2010-12-08,1,voice,1790498,1587040,203458
2010-12-08,2,voice,2495459,8783584,-6288125
2010-12-08,3,voice,703366,7411265,-6707899
2010-12-08,4,voice,9507629,8487194,1020435
2010-12-08,5,voice,4706227,1061807,3644420
2010-12-08,6,voice,3869663,5391151,-1521488
2010-12-08,7,voice,8513673,6738050,1775623
2010-12-08,8,voice,7282230,3563950,3718280
2010-12-08,9,voice,2479327,7188923,-4709596
2010-12-08,10,voice,3267577,2606656,660921
2010-12-08,11,voice,5459057,407793,5051264
2010-12-08,12,voice,624733,180750,443983
2010-12-08,13,voice,1123773,2278685,-1154912
2010-12-08,14,voice,3862809,8480368,-4617559
2010-12-08,15,voice,9212348,7859787,1352561
2010-12-08,16,voice,9100620,2403117,6697503
2010-12-08,17,voice,826588,8562904,-7736316
2010-12-08,18,voice,2037226,3666341,-1629115
2010-12-08,19,voice,9446073,4413125,5032948
2010-12-08,20,voice,2049719,6514973,-4465254
2010-12-08,21,voice,4290131,1504730,2785401
2010-12-08,22,voice,6683290,107258,6576032
2010-12-08,23,voice,9316977,3768423,5548554
2010-12-08,0,sms,4828437,415965,4412472
2010-12-08,1,sms,6204739,6225897,-21158
2010-12-08,2,sms,7747283,6762989,984294
2010-12-08,3,sms,5569759,3573991,1995768
2010-12-08,4,sms,523256,5531201,-5007945
2010-12-08,5,sms,7114762,3618641,3496121
2010-12-08,6,sms,2424689,8962839,-6538150
2010-12-08,7,sms,918496,2938815,-2020319
2010-12-08,8,sms,5498004,1825838,3672166
2010-12-08,9,sms,5293828,9437386,-4143558
2010-12-08,10,sms,1411800,7680738,-6268938
2010-12-08,11,sms,7133853,6396073,737780
2010-12-08,12,sms,9025461,7828398,1197063
2010-12-08,13,sms,6357434,8739732,-2382298
2010-12-08,14,sms,3763079,7234346,-3471267
2010-12-08,15,sms,7571270,1756187,5815083
2010-12-08,16,sms,2907415,6949525,-4042110
2010-12-08,17,sms,1374166,8595976,-7221810
2010-12-08,18,sms,1272850,8611045,-7338195
2010-12-08,19,sms,1357453,7014629,-5657176
2010-12-08,20,sms,7284822,5254091,2030731
2010-12-08,21,sms,4635048,4751234,-116186
2010-12-08,22,sms,9099390,5531386,3568004
2010-12-08,23,sms,9377223,6708990,2668233
2010-12-08,0,clr,8974879,3488015,5486864
2010-12-08,1,clr,8526780,8818432,-291652
2010-12-08,2,clr,8749653,3913678,4835975
2010-12-08,3,clr,3352015,2118522,1233493
2010-12-08,4,clr,5579684,3937851,1641833
2010-12-08,5,clr,1179140,6679428,-5500288
2010-12-08,6,clr,2098162,6280323,-4182161
2010-12-08,7,clr,2805123,7817774,-5012651
2010-12-08,8,clr,7876781,2497152,5379629
2010-12-08,9,clr,1439637,2775489,-1335852
2010-12-08,10,clr,4319012,3152629,1166383
2010-12-08,11,clr,8158213,3587115,4571098
2010-12-08,12,clr,1015731,9302337,-8286606
2010-12-08,13,clr,8855826,7502227,1353599
2010-12-08,14,clr,4976854,8808839,-3831985
2010-12-08,15,clr,3972512,7129930,-3157418
2010-12-08,16,clr,7542697,8871683,-1328986
2010-12-08,17,clr,5903813,5302191,601622
2010-12-08,18,clr,7858537,8290618,-432081
2010-12-08,19,clr,4435767,5502304,-1066537
2010-12-08,20,clr,2887130,320427,2566703
2010-12-08,21,clr,5232078,7324127,-2092049
2010-12-08,22,clr,2677727,8576915,-5899188
2010-12-08,23,clr,4054409,3064501,989908
2010-12-09,0,com,5602721,1657558,3945163
2010-12-09,1,com,4773368,9675589,-4902221
2010-12-09,2,com,1101207,6567879,-5466672
2010-12-09,3,com,7701037,1048582,6652455
2010-12-09,4,com,4490272,4552408,-62136
2010-12-09,5,com,3812905,8632082,-4819177
2010-12-09,6,com,2474941,6436489,-3961548
2010-12-09,7,com,1161562,8319558,-7157996
2010-12-09,8,com,1407808,8587039,-7179231
2010-12-09,9,com,1221799,9912302,-8690503
2010-12-09,10,com,4296405,5307513,-1011108
2010-12-09,11,com,1287113,6643233,-5356120
2010-12-09,12,com,2148388,6446548,-4298160
2010-12-09,13,com,2977200,2089582,887618
2010-12-09,14,com,6106794,7533014,-1426220
2010-12-09,15,com,5105754,4328012,777742
2010-12-09,16,com,483020,7745294,-7262274
2010-12-09,17,com,3568610,7840152,-4271542
2010-12-09,18,com,1010584,597619,412965
2010-12-09,19,com,2700442,2601662,98780
2010-12-09,20,com,7703777,6087046,1616731
2010-12-09,21,com,1089746,6984562,-5894816
2010-12-09,22,com,1122561,2164258,-1041697
2010-12-09,23,com,2288560,8823449,-6534889
2010-12-09,0,vou,6446743,7972576,-1525833
2010-12-09,1,vou,5384842,9637225,-4252383
2010-12-09,2,vou,6048898,1129373,4919525
2010-12-09,3,vou,36722,7023248,-6986526
2010-12-09,4,vou,4377261,8664889,-4287628
2010-12-09,5,vou,940110,223039,717071
2010-12-09,6,vou,2027495,8566442,-6538947
2010-12-09,7,vou,5731547,7652842,-1921295
2010-12-09,8,vou,3012377,8373052,-5360675
2010-12-09,9,vou,1728974,8040498,-6311524
2010-12-09,10,vou,834366,4773778,-3939412
2010-12-09,11,vou,2842347,9679533,-6837186
2010-12-09,12,vou,9164701,6036250,3128451
2010-12-09,13,vou,7233452,2479920,4753532
2010-12-09,14,vou,5935221,2500229,3434992
2010-12-09,15,vou,8520052,3230950,5289102
2010-12-09,16,vou,2459316,6487614,-4028298
2010-12-09,17,vou,2198248,5462730,-3264482
2010-12-09,18,vou,77641,3670110,-3592469
2010-12-09,19,vou,8891048,9651919,-760871
2010-12-09,20,vou,2249235,7000958,-4751723
2010-12-09,21,vou,9891861,2080994,7810867
2010-12-09,22,vou,3782371,9882697,-6100326
2010-12-09,23,vou,392076,4690250,-4298174
2010-12-09,0,cm,8741211,1732290,7008921
2010-12-09,1,cm,693700,9118094,-8424394
2010-12-09,2,cm,1622504,7464423,-5841919
2010-12-09,3,cm,7495579,6982526,513053
2010-12-09,4,cm,5646773,7702424,-2055651
2010-12-09,5,cm,6617234,2561615,4055619
2010-12-09,6,cm,8110976,184072,7926904
2010-12-09,7,cm,4164040,9363500,-5199460
2010-12-09,8,cm,9486283,9926520,-440237
2010-12-09,9,cm,7392533,6309239,1083294
2010-12-09,10,cm,4846736,8712020,-3865284
2010-12-09,11,cm,3344595,2682377,662218
2010-12-09,12,cm,5371125,4021555,1349570
2010-12-09,13,cm,9656018,2549681,7106337
2010-12-09,14,cm,9795079,746416,9048663
2010-12-09,15,cm,8553533,2960903,5592630
2010-12-09,16,cm,141765,678591,-536826
2010-12-09,17,cm,8831026,9130912,-299886
2010-12-09,18,cm,9340135,4586878,4753257
2010-12-09,19,cm,1107537,6655947,-5548410
2010-12-09,20,cm,3625365,7741120,-4115755
2010-12-09,21,cm,3651996,396682,3255314
2010-12-09,22,cm,5005618,9218717,-4213099
2010-12-09,23,cm,2116134,4101922,-1985788
2010-12-09,0,adj,4283982,6047869,-1763887
2010-12-09,1,adj,623815,5415388,-4791573
2010-12-09,2,adj,5507141,6868061,-1360920
2010-12-09,3,adj,2369439,9397012,-7027573
2010-12-09,4,adj,8729569,2849703,5879866
2010-12-09,5,adj,8695663,1902400,6793263
2010-12-09,6,adj,6624265,591896,6032369
2010-12-09,7,adj,3134352,4166188,-1031836
2010-12-09,8,adj,395629,9795384,-9399755
2010-12-09,9,adj,5512692,919473,4593219
2010-12-09,10,adj,6582614,3572184,3010430
2010-12-09,11,adj,784276,7513657,-6729381
2010-12-09,12,adj,7639996,5725777,1914219
2010-12-09,13,adj,963678,96603,867075
2010-12-09,14,adj,4631492,9798323,-5166831
2010-12-09,15,adj,6126473,7402922,-1276449
2010-12-09,16,adj,9676859,2074989,7601870
2010-12-09,17,adj,8826864,2337712,6489152
2010-12-09,18,adj,3472145,465159,3006986
2010-12-09,19,adj,5460901,6014340,-553439
2010-12-09,20,adj,2504378,9358599,-6854221
2010-12-09,21,adj,4810472,2573128,2237344
2010-12-09,22,adj,4224727,4329466,-104739
2010-12-09,23,adj,6331115,6069230,261885
2010-12-09,0,first,7592213,6130543,1461670
2010-12-09,1,first,2521102,1330611,1190491
2010-12-09,2,first,2961349,8885350,-5924001
2010-12-09,3,first,7656653,6100571,1556082
2010-12-09,4,first,1322184,5856570,-4534386
2010-12-09,5,first,4197442,1094967,3102475
2010-12-09,6,first,9221371,5836421,3384950
2010-12-09,7,first,1805303,6638192,-4832889
2010-12-09,8,first,8852904,9935339,-1082435
2010-12-09,9,first,836711,6362249,-5525538
2010-12-09,10,first,9142061,581933,8560128
2010-12-09,11,first,4757009,8335129,-3578120
2010-12-09,12,first,8184261,4348690,3835571
2010-12-09,13,first,7277868,2070202,5207666
2010-12-09,14,first,5034693,5549246,-514553
2010-12-09,15,first,7524043,9561354,-2037311
2010-12-09,16,first,4901169,516881,4384288
2010-12-09,17,first,2287363,4615673,-2328310
2010-12-09,18,first,5668431,659652,5008779
2010-12-09,19,first,1972890,6151709,-4178819
2010-12-09,20,first,1121192,6088927,-4967735
2010-12-09,21,first,5128147,4437758,690389
2010-12-09,22,first,7644071,3196082,4447989
2010-12-09,23,first,3345277,8800283,-5455006
2010-12-09,0,mon,4822416,7729664,-2907248
2010-12-09,1,mon,368984,5034568,-4665584
2010-12-09,2,mon,6939406,4501084,2438322
2010-12-09,3,mon,1708078,5662146,-3954068
2010-12-09,4,mon,438475,2660179,-2221704
2010-12-09,5,mon,2688860,7897106,-5208246
2010-12-09,6,mon,501648,1625400,-1123752
2010-12-09,7,mon,8672994,3124489,5548505
2010-12-09,8,mon,4664738,1476732,3188006
2010-12-09,9,mon,3933188,1176311,2756877
2010-12-09,10,mon,4154671,5190157,-1035486
2010-12-09,11,mon,7079617,8054121,-974504
2010-12-09,12,mon,8812779,448055,8364724
2010-12-09,13,mon,8416459,6293816,2122643
2010-12-09,14,mon,4253197,4058563,194634
2010-12-09,15,mon,8297778,632910,7664868
2010-12-09,16,mon,5984940,6297635,-312695
2010-12-09,17,mon,1799754,2853940,-1054186
2010-12-09,18,mon,2071821,7307946,-5236125
2010-12-09,19,mon,176028,7452329,-7276301
2010-12-09,20,mon,3459545,168079,3291466
2010-12-09,21,mon,2451155,4407916,-1956761
2010-12-09,22,mon,4711473,3889447,822026
2010-12-09,23,mon,8279133,2171096,6108037
2010-12-09,0,data,8413645,9346921,-933276
2010-12-09,1,data,2427958,3211556,-783598
2010-12-09,2,data,1087869,2975871,-1888002
2010-12-09,3,data,7282803,5709394,1573409
2010-12-09,4,data,8690540,4941875,3748665
2010-12-09,5,data,5689771,3072307,2617464
2010-12-09,6,data,4909180,1222175,3687005
2010-12-09,7,data,8754750,1999457,6755293
2010-12-09,8,data,485382,8345933,-7860551
2010-12-09,9,data,7877996,3078438,4799558
2010-12-09,10,data,5939399,7265119,-1325720
2010-12-09,11,data,5303350,613170,4690180
2010-12-09,12,data,7127890,9928023,-2800133
2010-12-09,13,data,1308407,4279765,-2971358
2010-12-09,14,data,2835979,6541574,-3705595
2010-12-09,15,data,4288510,2424099,1864411
2010-12-09,16,data,5706196,5330486,375710
2010-12-09,17,data,6092595,8792952,-2700357
2010-12-09,18,data,7812341,9591742,-1779401
2010-12-09,19,data,7887418,4197716,3689702
2010-12-09,20,data,2242556,3672159,-1429603
2010-12-09,21,data,5531081,6464726,-933645
2010-12-09,22,data,8814626,216082,8598544
2010-12-09,23,data,875215,12731,862484
2010-12-09,0,voice,2703504,3744932,-1041428
2010-12-09,1,voice,7617280,7896500,-279220
2010-12-09,2,voice,5555788,7661417,-2105629
2010-12-09,3,voice,2771690,7563871,-4792181
2010-12-09,4,voice,7167327,9559855,-2392528
2010-12-09,5,voice,6165393,1564640,4600753
2010-12-09,6,voice,3147321,2387695,759626
2010-12-09,7,voice,161628,3886750,-3725122
2010-12-09,8,voice,6544223,9504035,-2959812
2010-12-09,9,voice,2346769,495240,1851529
2010-12-09,10,voice,1282688,3410344,-2127656
2010-12-09,11,voice,5257905,3617725,1640180
2010-12-09,12,voice,244175,8478339,-8234164
2010-12-09,13,voice,8349464,4577618,3771846
2010-12-09,14,voice,3091407,6368220,-3276813
2010-12-09,15,voice,7219955,8329792,-1109837
2010-12-09,16,voice,9718513,8264602,1453911
2010-12-09,17,voice,9320033,7413636,1906397
2010-12-09,18,voice,9539911,5526101,4013810
2010-12-09,19,voice,8597063,8751174,-154111
2010-12-09,20,voice,6377721,9323987,-2946266
2010-12-09,21,voice,1201080,5476074,-4274994
2010-12-09,22,voice,9532487,5955482,3577005
2010-12-09,23,voice,1179141,748418,430723
2010-12-09,0,sms,8155118,4498296,3656822
2010-12-09,1,sms,6953861,3906485,3047376
2010-12-09,2,sms,3948307,3516000,432307
2010-12-09,3,sms,6359263,5418976,940287
2010-12-09,4,sms,2645142,3779841,-1134699
2010-12-09,5,sms,9963513,5206947,4756566
2010-12-09,6,sms,5084659,9337472,-4252813
2010-12-09,7,sms,5557136,8833123,-3275987
2010-12-09,8,sms,2004636,1390093,614543
2010-12-09,9,sms,3088615,3200745,-112130
2010-12-09,10,sms,2961476,50988,2910488
2010-12-09,11,sms,23383,8303202,-8279819
2010-12-09,12,sms,6363004,83952,6279052
2010-12-09,13,sms,9873694,7486743,2386951
2010-12-09,14,sms,7347413,6959851,387562
2010-12-09,15,sms,6292726,8337221,-2044495
2010-12-09,16,sms,9322667,9716568,-393901
2010-12-09,17,sms,252411,1511323,-1258912
2010-12-09,18,sms,2049589,2964885,-915296
2010-12-09,19,sms,3176933,9890982,-6714049
2010-12-09,20,sms,6164138,2753454,3410684
2010-12-09,21,sms,5481793,3458246,2023547
2010-12-09,22,sms,3061796,9051164,-5989368
2010-12-09,23,sms,1225414,8653999,-7428585
2010-12-09,0,clr,9838997,9150555,688442
2010-12-09,1,clr,1565052,9863716,-8298664
2010-12-09,2,clr,2232437,3363241,-1130804
2010-12-09,3,clr,6025057,5112958,912099
2010-12-09,4,clr,4988188,1356285,3631903
2010-12-09,5,clr,3414714,2546771,867943
2010-12-09,6,clr,484019,8441599,-7957580
2010-12-09,7,clr,8256884,3708180,4548704
2010-12-09,8,clr,8869112,4597360,4271752
2010-12-09,9,clr,4202606,1971139,2231467
2010-12-09,10,clr,307396,3409501,-3102105
2010-12-09,11,clr,3247603,7045602,-3797999
2010-12-09,12,clr,5093378,9463702,-4370324
2010-12-09,13,clr,2366195,7772828,-5406633
2010-12-09,14,clr,9178723,1483418,7695305
2010-12-09,15,clr,958709,3564798,-2606089
2010-12-09,16,clr,7579380,6289284,1290096
2010-12-09,17,clr,3845152,7629061,-3783909
2010-12-09,18,clr,4382479,7935695,-3553216
2010-12-09,19,clr,6046862,4790567,1256295
2010-12-09,20,clr,9349383,8580759,768624
2010-12-09,21,clr,6837799,9284929,-2447130
2010-12-09,22,clr,3893496,8768958,-4875462
2010-12-09,23,clr,5196785,8127400,-2930615
2010-12-10,0,com,8086076,7630815,455261
2010-12-10,1,com,1721748,9784027,-8062279
2010-12-10,2,com,9918472,9553873,364599
2010-12-10,3,com,5032458,9979303,-4946845
2010-12-10,4,com,219098,3848979,-3629881
2010-12-10,5,com,8409361,7682408,726953
2010-12-10,6,com,3718259,5182865,-1464606
2010-12-10,7,com,3073316,6474469,-3401153
2010-12-10,8,com,932232,9181958,-8249726
2010-12-10,9,com,6848726,5810766,1037960
2010-12-10,10,com,8589203,7629456,959747
2010-12-10,11,com,9323349,2818850,6504499
2010-12-10,12,com,8372316,8781265,-408949
2010-12-10,13,com,6639115,9277423,-2638308
2010-12-10,14,com,9413416,667440,8745976
2010-12-10,15,com,3465289,5571872,-2106583
2010-12-10,16,com,5537115,670431,4866684
2010-12-10,17,com,2415501,9308406,-6892905
2010-12-10,18,com,6973110,791198,6181912
2010-12-10,19,com,2868981,9170310,-6301329
2010-12-10,20,com,2007151,1011084,996067
2010-12-10,21,com,7422814,102104,7320710
2010-12-10,22,com,2907335,3350363,-443028
2010-12-10,23,com,4536640,6460708,-1924068
2010-12-10,0,vou,3232707,3575709,-343002
2010-12-10,1,vou,5312139,2406644,2905495
2010-12-10,2,vou,6696943,6977317,-280374
2010-12-10,3,vou,39915,420574,-380659
2010-12-10,4,vou,5705098,5730934,-25836
2010-12-10,5,vou,3098921,4657623,-1558702
2010-12-10,6,vou,3304461,796957,2507504
2010-12-10,7,vou,3727717,5741376,-2013659
2010-12-10,8,vou,1873670,2244734,-371064
2010-12-10,9,vou,6847261,6103190,744071
2010-12-10,10,vou,8796948,7972779,824169
2010-12-10,11,vou,9561985,4334463,5227522
2010-12-10,12,vou,8292685,4730060,3562625
2010-12-10,13,vou,5722391,8262816,-2540425
2010-12-10,14,vou,4016351,853678,3162673
2010-12-10,15,vou,7255675,721170,6534505
2010-12-10,16,vou,1360578,4683779,-3323201
2010-12-10,17,vou,7618290,5303196,2315094
2010-12-10,18,vou,4690777,5768329,-1077552
2010-12-10,19,vou,3398230,74309,3323921
2010-12-10,20,vou,9104767,2660002,6444765
2010-12-10,21,vou,2303832,3834241,-1530409
2010-12-10,22,vou,7466483,1402686,6063797
2010-12-10,23,vou,9046066,7207543,1838523
2010-12-10,0,cm,1094114,8077484,-6983370
2010-12-10,1,cm,7437023,8297758,-860735
2010-12-10,2,cm,7577027,6371303,1205724
2010-12-10,3,cm,611495,7502216,-6890721
2010-12-10,4,cm,265016,4461062,-4196046
2010-12-10,5,cm,4205656,1440731,2764925
2010-12-10,6,cm,3787429,5196053,-1408624
2010-12-10,7,cm,5080023,9657048,-4577025
2010-12-10,8,cm,5907199,1377546,4529653
2010-12-10,9,cm,6255204,1079797,5175407
2010-12-10,10,cm,2683402,3289945,-606543
2010-12-10,11,cm,7378402,7819208,-440806
2010-12-10,12,cm,4290671,987840,3302831
2010-12-10,13,cm,1273403,5853195,-4579792
2010-12-10,14,cm,9815905,1512304,8303601
2010-12-10,15,cm,8333354,7415470,917884
2010-12-10,16,cm,4761115,6838472,-2077357
2010-12-10,17,cm,5765871,4530126,1235745
2010-12-10,18,cm,6651068,261053,6390015
2010-12-10,19,cm,7385772,6035751,1350021
2010-12-10,20,cm,3224503,9867480,-6642977
2010-12-10,21,cm,6778399,2828736,3949663
2010-12-10,22,cm,3155292,3770091,-614799
2010-12-10,23,cm,9671189,6725882,2945307
2010-12-10,0,adj,9878473,7871589,2006884
2010-12-10,1,adj,6943958,7454134,-510176
2010-12-10,2,adj,3719968,2486006,1233962
2010-12-10,3,adj,3457528,5373753,-1916225
2010-12-10,4,adj,3024093,6591668,-3567575
2010-12-10,5,adj,7378878,3926795,3452083
2010-12-10,6,adj,2520793,2796954,-276161
2010-12-10,7,adj,6323847,5651515,672332
2010-12-10,8,adj,6634527,201914,6432613
2010-12-10,9,adj,3272044,2547905,724139
2010-12-10,10,adj,2200414,2158732,41682
2010-12-10,11,adj,2562847,8126619,-5563772
2010-12-10,12,adj,8821807,2548453,6273354
2010-12-10,13,adj,6946138,4244975,2701163
2010-12-10,14,adj,6087004,894431,5192573
2010-12-10,15,adj,5943846,2175458,3768388
2010-12-10,16,adj,6189116,3587730,2601386
2010-12-10,17,adj,2249809,5518601,-3268792
2010-12-10,18,adj,3719704,2633665,1086039
2010-12-10,19,adj,9007441,5934149,3073292
2010-12-10,20,adj,2531173,9730125,-7198952
2010-12-10,21,adj,8170063,5345955,2824108
2010-12-10,22,adj,358327,5250702,-4892375
2010-12-10,23,adj,3238937,655764,2583173
2010-12-10,0,first,9924960,8387996,1536964
2010-12-10,1,first,9196738,8208538,988200
2010-12-10,2,first,9107156,562201,8544955
2010-12-10,3,first,1781438,1958239,-176801
2010-12-10,4,first,3874317,5342367,-1468050
2010-12-10,5,first,5661869,2156050,3505819
2010-12-10,6,first,1738477,7699969,-5961492
2010-12-10,7,first,2015753,8111872,-6096119
2010-12-10,8,first,2355959,6826275,-4470316
2010-12-10,9,first,549582,3385377,-2835795
2010-12-10,10,first,2438250,5522650,-3084400
2010-12-10,11,first,4521878,1543999,2977879
2010-12-10,12,first,6232760,9298523,-3065763
2010-12-10,13,first,3387730,4032368,-644638
2010-12-10,14,first,3150968,1281217,1869751
2010-12-10,15,first,4336719,2224994,2111725
2010-12-10,16,first,7654437,942155,6712282
2010-12-10,17,first,2832476,9967294,-7134818
2010-12-10,18,first,8977973,4355859,4622114
2010-12-10,19,first,7224924,417383,6807541
2010-12-10,20,first,5364408,235480,5128928
2010-12-10,21,first,2457820,6069658,-3611838
2010-12-10,22,first,4028845,2649221,1379624
2010-12-10,23,first,6655017,3042682,3612335
2010-12-10,0,mon,5701994,8483685,-2781691
2010-12-10,1,mon,4561048,5975043,-1413995
2010-12-10,2,mon,3912467,7780838,-3868371
2010-12-10,3,mon,2241374,6967640,-4726266
2010-12-10,4,mon,3290651,7836076,-4545425
2010-12-10,5,mon,7342464,7202030,140434
2010-12-10,6,mon,1361640,7965640,-6604000
2010-12-10,7,mon,9576624,4636153,4940471
2010-12-10,8,mon,8109603,6422303,1687300
2010-12-10,9,mon,9529490,7643404,1886086
2010-12-10,10,mon,2616704,7415901,-4799197
2010-12-10,11,mon,4007614,1935611,2072003
2010-12-10,12,mon,8670679,1380293,7290386
2010-12-10,13,mon,2015938,9093249,-7077311
2010-12-10,14,mon,3446377,961107,2485270
2010-12-10,15,mon,4958269,8513111,-3554842
2010-12-10,16,mon,7876476,5828424,2048052
2010-12-10,17,mon,2936628,6765919,-3829291
2010-12-10,18,mon,84194,272262,-188068
2010-12-10,19,mon,1284430,2422518,-1138088
2010-12-10,20,mon,8485746,8875980,-390234
2010-12-10,21,mon,9873616,1737291,8136325
2010-12-10,22,mon,7348889,7174492,174397
2010-12-10,23,mon,2121539,2936319,-814780
2010-12-10,0,data,6669583,2405180,4264403
2010-12-10,1,data,6404601,7369047,-964446
2010-12-10,2,data,4236901,6946592,-2709691
2010-12-10,3,data,4727552,5376068,-648516
2010-12-10,4,data,3741692,3176468,565224
2010-12-10,5,data,7563439,4866465,2696974
2010-12-10,6,data,9964158,7589149,2375009
2010-12-10,7,data,5174991,9391464,-4216473
2010-12-10,8,data,7326681,929852,6396829
2010-12-10,9,data,2344462,4217394,-1872932
2010-12-10,10,data,9657803,1677010,7980793
2010-12-10,11,data,843111,6949540,-6106429
2010-12-10,12,data,7108173,3566756,3541417
2010-12-10,13,data,5401978,1062527,4339451
2010-12-10,14,data,634573,9295705,-8661132
2010-12-10,15,data,7615080,776661,6838419
2010-12-10,16,data,3771568,7343337,-3571769
2010-12-10,17,data,9450773,6086506,3364267
2010-12-10,18,data,427326,9469167,-9041841
2010-12-10,19,data,1268120,1628738,-360618
2010-12-10,20,data,1163587,2636696,-1473109
2010-12-10,21,data,7395316,4131825,3263491
2010-12-10,22,data,8805900,1534967,7270933
2010-12-10,23,data,8098362,5415998,2682364
2010-12-10,0,voice,6754630,2054201,4700429
2010-12-10,1,voice,9183774,7426630,1757144
2010-12-10,2,voice,5222819,3208452,2014367
2010-12-10,3,voice,5607985,7976516,-2368531
2010-12-10,4,voice,2285860,8336564,-6050704
2010-12-10,5,voice,7187688,7489007,-301319
2010-12-10,6,voice,7302167,5157783,2144384
2010-12-10,7,voice,9547826,9745680,-197854
2010-12-10,8,voice,6996029,5626721,1369308
2010-12-10,9,voice,2330962,8636867,-6305905
2010-12-10,10,voice,2929060,7609271,-4680211
2010-12-10,11,voice,1774791,2560347,-785556
2010-12-10,12,voice,8768052,6872208,1895844
2010-12-10,13,voice,2398468,292371,2106097
2010-12-10,14,voice,7917432,9978737,-2061305
2010-12-10,15,voice,3015636,6354567,-3338931
2010-12-10,16,voice,1989036,9378842,-7389806
2010-12-10,17,voice,4987186,4776279,210907
2010-12-10,18,voice,5256864,4024328,1232536
2010-12-10,19,voice,9854708,9497752,356956
2010-12-10,20,voice,7857264,4237043,3620221
2010-12-10,21,voice,7619533,1390598,6228935
2010-12-10,22,voice,8951211,9660041,-708830
2010-12-10,23,voice,5565424,6408656,-843232
2010-12-10,0,sms,1721824,8620613,-6898789
2010-12-10,1,sms,1319060,1619001,-299941
2010-12-10,2,sms,7632470,4515249,3117221
2010-12-10,3,sms,1305156,5554618,-4249462
2010-12-10,4,sms,2835612,7743580,-4907968
2010-12-10,5,sms,9207635,1950536,7257099
2010-12-10,6,sms,3034652,1252696,1781956
2010-12-10,7,sms,9707337,821893,8885444
2010-12-10,8,sms,5317411,9921254,-4603843
2010-12-10,9,sms,243301,129064,114237
2010-12-10,10,sms,1387537,6195010,-4807473
2010-12-10,11,sms,6632380,6933137,-300757
2010-12-10,12,sms,9120203,7022834,2097369
2010-12-10,13,sms,547624,2398847,-1851223
2010-12-10,14,sms,5040067,1094873,3945194
2010-12-10,15,sms,7206020,4365300,2840720
2010-12-10,16,sms,5508992,2974743,2534249
2010-12-10,17,sms,3230365,1739035,1491330
2010-12-10,18,sms,7638150,1188859,6449291
2010-12-10,19,sms,9302262,8734575,567687
2010-12-10,20,sms,5689370,3278349,2411021
2010-12-10,21,sms,982867,4408566,-3425699
2010-12-10,22,sms,4097564,3063910,1033654
2010-12-10,23,sms,574769,459586,115183
2010-12-10,0,clr,3421405,407774,3013631
2010-12-10,1,clr,8913910,3097938,5815972
2010-12-10,2,clr,4521200,8289621,-3768421
2010-12-10,3,clr,1049165,822180,226985
2010-12-10,4,clr,2293224,60824,2232400
2010-12-10,5,clr,2944191,2057884,886307
2010-12-10,6,clr,3038063,7755168,-4717105
2010-12-10,7,clr,8155574,1684030,6471544
2010-12-10,8,clr,7939985,102736,7837249
2010-12-10,9,clr,8556402,4643347,3913055
2010-12-10,10,clr,315973,3217550,-2901577
2010-12-10,11,clr,8873360,8052732,820628
2010-12-10,12,clr,4924642,717276,4207366
2010-12-10,13,clr,910303,8986491,-8076188
2010-12-10,14,clr,6914641,4744014,2170627
2010-12-10,15,clr,1882237,656823,1225414
2010-12-10,16,clr,4493108,4599938,-106830
2010-12-10,17,clr,1896371,7078660,-5182289
2010-12-10,18,clr,4383215,4677079,-293864
2010-12-10,19,clr,9452659,8865818,586841
2010-12-10,20,clr,269750,3911158,-3641408
2010-12-10,21,clr,7843765,1781724,6062041
2010-12-10,22,clr,2168762,4043533,-1874771
2010-12-10,23,clr,4111125,7376342,-3265217
2010-12-11,0,com,2368107,9865570,-7497463
2010-12-11,1,com,2307489,5539357,-3231868
2010-12-11,2,com,9867311,1614812,8252499
2010-12-11,3,com,2965192,942283,2022909
2010-12-11,4,com,407877,7416521,-7008644
2010-12-11,5,com,6376883,881796,5495087
2010-12-11,6,com,1217287,9191892,-7974605
2010-12-11,7,com,1485475,9927608,-8442133
2010-12-11,8,com,5207003,9949705,-4742702
2010-12-11,9,com,9645834,9273532,372302
2010-12-11,10,com,5355940,3794287,1561653
2010-12-11,11,com,9919006,7751012,2167994
2010-12-11,12,com,1714999,2737422,-1022423
2010-12-11,13,com,8651934,3587224,5064710
2010-12-11,14,com,3336925,5388318,-2051393
2010-12-11,15,com,9598007,6339871,3258136
2010-12-11,16,com,3993913,4268481,-274568
2010-12-11,17,com,4959682,8670467,-3710785
2010-12-11,18,com,7498496,2767835,4730661
2010-12-11,19,com,1867787,7127568,-5259781
2010-12-11,20,com,5438857,2926802,2512055
2010-12-11,21,com,9583242,8241085,1342157
2010-12-11,22,com,9080240,9671339,-591099
2010-12-11,23,com,7830372,7244410,585962
2010-12-11,0,vou,8504797,2237074,6267723
2010-12-11,1,vou,1317104,9084596,-7767492
2010-12-11,2,vou,9731468,368501,9362967
2010-12-11,3,vou,983599,2917968,-1934369
2010-12-11,4,vou,1041369,954557,86812
2010-12-11,5,vou,8676082,3229582,5446500
2010-12-11,6,vou,1938156,8407747,-6469591
2010-12-11,7,vou,7071870,3199111,3872759
2010-12-11,8,vou,8404176,7970419,433757
2010-12-11,9,vou,9809233,6842757,2966476
2010-12-11,10,vou,879114,5946874,-5067760
2010-12-11,11,vou,5290408,150507,5139901
2010-12-11,12,vou,2599936,4286480,-1686544
2010-12-11,13,vou,3440100,1512873,1927227
2010-12-11,14,vou,1374580,6865922,-5491342
2010-12-11,15,vou,469120,6568149,-6099029
2010-12-11,16,vou,1984371,6975607,-4991236
2010-12-11,17,vou,3544621,1765043,1779578
2010-12-11,18,vou,8425509,9220993,-795484
2010-12-11,19,vou,494423,6131420,-5636997
2010-12-11,20,vou,9083111,2413903,6669208
2010-12-11,21,vou,915610,3025392,-2109782
2010-12-11,22,vou,4280782,1602356,2678426
2010-12-11,23,vou,9539147,8401270,1137877
2010-12-11,0,cm,3532107,1081995,2450112
2010-12-11,1,cm,5135264,2332424,2802840
2010-12-11,2,cm,173152,7382065,-7208913
2010-12-11,3,cm,5913535,3658838,2254697
2010-12-11,4,cm,8642474,7374415,1268059
2010-12-11,5,cm,1585113,8176815,-6591702
2010-12-11,6,cm,3165141,4252290,-1087149
2010-12-11,7,cm,453468,285333,168135
2010-12-11,8,cm,9306123,8187150,1118973
2010-12-11,9,cm,1133075,7654979,-6521904
2010-12-11,10,cm,6045032,2286131,3758901
2010-12-11,11,cm,2230378,7524668,-5294290
2010-12-11,12,cm,8902545,4643823,4258722
2010-12-11,13,cm,2328467,9958989,-7630522
2010-12-11,14,cm,5118057,6832088,-1714031
2010-12-11,15,cm,1194139,2441914,-1247775
2010-12-11,16,cm,2321238,5046600,-2725362
2010-12-11,17,cm,3259445,1254328,2005117
2010-12-11,18,cm,6013201,3358415,2654786
2010-12-11,19,cm,4659917,499014,4160903
2010-12-11,20,cm,2701816,5702977,-3001161
2010-12-11,21,cm,2090668,9878674,-7788006
2010-12-11,22,cm,9848702,4134179,5714523
2010-12-11,23,cm,339078,4593490,-4254412
2010-12-11,0,adj,2031594,2340819,-309225
2010-12-11,1,adj,759626,2984392,-2224766
2010-12-11,2,adj,8277711,6906084,1371627
2010-12-11,3,adj,4415405,6211327,-1795922
2010-12-11,4,adj,5387646,7564830,-2177184
2010-12-11,5,adj,8907611,5532013,3375598
2010-12-11,6,adj,5499577,169126,5330451
2010-12-11,7,adj,5927131,3828418,2098713
2010-12-11,8,adj,7643381,6976513,666868
2010-12-11,9,adj,3619602,3604336,15266
2010-12-11,10,adj,5722820,3033100,2689720
2010-12-11,11,adj,3984,423678,-419694
2010-12-11,12,adj,8814785,3492512,5322273
2010-12-11,13,adj,7763951,4329322,3434629
2010-12-11,14,adj,4650638,1271847,3378791
2010-12-11,15,adj,6224350,8930817,-2706467
2010-12-11,16,adj,2074985,5378386,-3303401
2010-12-11,17,adj,6108487,9606895,-3498408
2010-12-11,18,adj,7215075,5598137,1616938
2010-12-11,19,adj,1821412,1705660,115752
2010-12-11,20,adj,9122226,9806092,-683866
2010-12-11,21,adj,6618225,321161,6297064
2010-12-11,22,adj,545028,3132529,-2587501
2010-12-11,23,adj,588591,2076293,-1487702
2010-12-11,0,first,9851802,1989636,7862166
2010-12-11,1,first,8268592,2128057,6140535
2010-12-11,2,first,5180792,7190387,-2009595
2010-12-11,3,first,5954941,7213742,-1258801
2010-12-11,4,first,5323078,8343594,-3020516
2010-12-11,5,first,7059879,6868214,191665
2010-12-11,6,first,5066949,6525212,-1458263
2010-12-11,7,first,1047183,8947158,-7899975
2010-12-11,8,first,7276167,149762,7126405
2010-12-11,9,first,6091646,4759287,1332359
2010-12-11,10,first,2737485,1513792,1223693
2010-12-11,11,first,6117746,8204416,-2086670
2010-12-11,12,first,5471062,8517067,-3046005
2010-12-11,13,first,2507134,8720931,-6213797
2010-12-11,14,first,9966001,1988181,7977820
2010-12-11,15,first,7738744,6364184,1374560
2010-12-11,16,first,2832575,1535166,1297409
2010-12-11,17,first,7756672,1651636,6105036
2010-12-11,18,first,8138080,509013,7629067
2010-12-11,19,first,9518442,5833653,3684789
2010-12-11,20,first,1656578,4363493,-2706915
2010-12-11,21,first,3848765,2488118,1360647
2010-12-11,22,first,6897236,6371337,525899
2010-12-11,23,first,9744989,3330420,6414569
2010-12-11,0,mon,1531866,3612681,-2080815
2010-12-11,1,mon,6986209,7258772,-272563
2010-12-11,2,mon,6946206,8472755,-1526549
2010-12-11,3,mon,1630770,7716269,-6085499
2010-12-11,4,mon,2740293,4577337,-1837044
2010-12-11,5,mon,7377508,3957303,3420205
2010-12-11,6,mon,3652529,8878611,-5226082
2010-12-11,7,mon,2472345,816199,1656146
2010-12-11,8,mon,6223964,2964360,3259604
2010-12-11,9,mon,7768481,9210229,-1441748
2010-12-11,10,mon,304127,9128231,-8824104
2010-12-11,11,mon,6337128,854636,5482492
2010-12-11,12,mon,2009517,2345581,-336064
2010-12-11,13,mon,3427689,8719372,-5291683
2010-12-11,14,mon,712493,1487064,-774571
2010-12-11,15,mon,6374425,4798127,1576298
2010-12-11,16,mon,5187958,4261878,926080
2010-12-11,17,mon,185786,3732911,-3547125
2010-12-11,18,mon,7667603,6893444,774159
2010-12-11,19,mon,744569,6536675,-5792106
2010-12-11,20,mon,6865942,4207869,2658073
2010-12-11,21,mon,6291044,1477922,4813122
2010-12-11,22,mon,941747,7507860,-6566113
2010-12-11,23,mon,1031567,1189236,-157669
2010-12-11,0,data,9311284,4698942,4612342
2010-12-11,1,data,2218054,3250104,-1032050
2010-12-11,2,data,7118835,3261836,3856999
2010-12-11,3,data,6567417,2510595,4056822
2010-12-11,4,data,8395162,5561260,2833902
2010-12-11,5,data,7683184,2306188,5376996
2010-12-11,6,data,6344155,8750036,-2405881
2010-12-11,7,data,1474657,9625797,-8151140
2010-12-11,8,data,3051403,7070145,-4018742
2010-12-11,9,data,2250958,1657654,593304
2010-12-11,10,data,5441345,9684961,-4243616
2010-12-11,11,data,8151468,7326915,824553
2010-12-11,12,data,5812062,1691339,4120723
2010-12-11,13,data,2256416,4155542,-1899126
2010-12-11,14,data,4003994,4350663,-346669
2010-12-11,15,data,5494155,3013878,2480277
2010-12-11,16,data,9080604,7963757,1116847
2010-12-11,17,data,9959364,4334781,5624583
2010-12-11,18,data,8885105,2374475,6510630
2010-12-11,19,data,1944739,7950334,-6005595
2010-12-11,20,data,7474504,8529150,-1054646
2010-12-11,21,data,7706281,416886,7289395
2010-12-11,22,data,7765592,1355525,6410067
2010-12-11,23,data,3011064,136133,2874931
2010-12-11,0,voice,7002149,5470569,1531580
2010-12-11,1,voice,3391569,2910774,480795
2010-12-11,2,voice,1758474,4372766,-2614292
2010-12-11,3,voice,3750308,8506517,-4756209
2010-12-11,4,voice,1384537,7051494,-5666957
2010-12-11,5,voice,8862703,2688813,6173890
2010-12-11,6,voice,4201081,8186571,-3985490
2010-12-11,7,voice,33787,3076643,-3042856
2010-12-11,8,voice,4571615,4742053,-170438
2010-12-11,9,voice,4637102,2000538,2636564
2010-12-11,10,voice,1984593,8943282,-6958689
2010-12-11,11,voice,3479217,8837125,-5357908
2010-12-11,12,voice,3276421,2469084,807337
2010-12-11,13,voice,8867348,8595323,272025
2010-12-11,14,voice,6168000,6803962,-635962
2010-12-11,15,voice,2488873,3063214,-574341
2010-12-11,16,voice,4345990,3243059,1102931
2010-12-11,17,voice,6399915,7991936,-1592021
2010-12-11,18,voice,935118,9968481,-9033363
2010-12-11,19,voice,1247697,1131955,115742
2010-12-11,20,voice,4086030,934708,3151322
2010-12-11,21,voice,4748745,5253196,-504451
2010-12-11,22,voice,5141568,6958129,-1816561
2010-12-11,23,voice,8493335,4373888,4119447
2010-12-11,0,sms,855690,1672909,-817219
2010-12-11,1,sms,9984711,6335439,3649272
2010-12-11,2,sms,1379590,3754626,-2375036
2010-12-11,3,sms,6041579,6914734,-873155
2010-12-11,4,sms,5722783,781501,4941282
2010-12-11,5,sms,6799969,9988045,-3188076
2010-12-11,6,sms,4012515,5230147,-1217632
2010-12-11,7,sms,8326503,2352137,5974366
2010-12-11,8,sms,8078364,3531561,4546803
2010-12-11,9,sms,6863725,4988192,1875533
2010-12-11,10,sms,8362021,4684877,3677144
2010-12-11,11,sms,4982420,3984109,998311
2010-12-11,12,sms,7836289,3035851,4800438
2010-12-11,13,sms,4971524,377551,4593973
2010-12-11,14,sms,2506185,3645359,-1139174
2010-12-11,15,sms,4911976,6388149,-1476173
2010-12-11,16,sms,8746143,3728355,5017788
2010-12-11,17,sms,9068713,4162677,4906036
2010-12-11,18,sms,1428365,3936027,-2507662
2010-12-11,19,sms,2891047,1249664,1641383
2010-12-11,20,sms,9554101,6438272,3115829
2010-12-11,21,sms,6026324,6188190,-161866
2010-12-11,22,sms,7968048,1971417,5996631
2010-12-11,23,sms,4635244,4528950,106294
2010-12-11,0,clr,8409591,9183766,-774175
2010-12-11,1,clr,4217007,7028937,-2811930
2010-12-11,2,clr,9296087,9004465,291622
2010-12-11,3,clr,9876646,8702811,1173835
2010-12-11,4,clr,7242986,8825060,-1582074
2010-12-11,5,clr,9217210,8545379,671831
2010-12-11,6,clr,4171133,6077698,-1906565
2010-12-11,7,clr,5984293,9152570,-3168277
2010-12-11,8,clr,4789643,9622330,-4832687
2010-12-11,9,clr,9318813,3021239,6297574
2010-12-11,10,clr,5741135,5586636,154499
2010-12-11,11,clr,6131047,7521129,-1390082
2010-12-11,12,clr,3749548,7817957,-4068409
2010-12-11,13,clr,1629324,5240762,-3611438
2010-12-11,14,clr,7437380,8044470,-607090
2010-12-11,15,clr,4893788,9962470,-5068682
2010-12-11,16,clr,109467,1541134,-1431667
2010-12-11,17,clr,510218,4729492,-4219274
2010-12-11,18,clr,8705574,6588510,2117064
2010-12-11,19,clr,4742950,2862193,1880757
2010-12-11,20,clr,2070242,8638772,-6568530
2010-12-11,21,clr,4215144,1602933,2612211
2010-12-11,22,clr,477669,614016,-136347
2010-12-11,23,clr,3983746,7772705,-3788959
2010-12-12,0,com,3026547,1013521,2013026
2010-12-12,1,com,389519,2350166,-1960647
2010-12-12,2,com,5688378,9692415,-4004037
2010-12-12,3,com,9172660,8041402,1131258
2010-12-12,4,com,8452787,753669,7699118
2010-12-12,5,com,5429881,1611500,3818381
2010-12-12,6,com,2429411,2082774,346637
2010-12-12,7,com,9098225,7556125,1542100
2010-12-12,8,com,4644147,8853592,-4209445
2010-12-12,9,com,2155879,3201645,-1045766
2010-12-12,10,com,4531354,4819116,-287762
2010-12-12,11,com,795650,138114,657536
2010-12-12,12,com,7074007,3525088,3548919
2010-12-12,13,com,6908835,6176449,732386
2010-12-12,14,com,6530755,5598663,932092
2010-12-12,15,com,4242194,9499416,-5257222
2010-12-12,16,com,6689810,2286911,4402899
2010-12-12,17,com,9541249,489249,9052000
2010-12-12,18,com,4775358,5397189,-621831
2010-12-12,19,com,4793773,6715156,-1921383
2010-12-12,20,com,8756558,6740710,2015848
2010-12-12,21,com,202945,6965864,-6762919
2010-12-12,22,com,1950398,4160350,-2209952
2010-12-12,23,com,5772004,2086543,3685461
2010-12-12,0,vou,5936391,1556430,4379961
2010-12-12,1,vou,3150630,8795926,-5645296
2010-12-12,2,vou,2037416,5183856,-3146440
2010-12-12,3,vou,9643381,3639765,6003616
2010-12-12,4,vou,9334360,635395,8698965
2010-12-12,5,vou,1436399,289850,1146549
2010-12-12,6,vou,493520,3240362,-2746842
2010-12-12,7,vou,3100720,3940279,-839559
2010-12-12,8,vou,8479705,5113001,3366704
2010-12-12,9,vou,6157002,4427652,1729350
2010-12-12,10,vou,6817971,2765808,4052163
2010-12-12,11,vou,6595297,590244,6005053
2010-12-12,12,vou,6110856,9427836,-3316980
2010-12-12,13,vou,3604242,6348802,-2744560
2010-12-12,14,vou,4608436,7810248,-3201812
2010-12-12,15,vou,5192318,163400,5028918
2010-12-12,16,vou,1914094,3846502,-1932408
2010-12-12,17,vou,4548759,5790928,-1242169
2010-12-12,18,vou,4077828,2142315,1935513
2010-12-12,19,vou,782704,8840878,-8058174
2010-12-12,20,vou,1739582,9418537,-7678955
2010-12-12,21,vou,8863430,4968254,3895176
2010-12-12,22,vou,4759472,4660827,98645
2010-12-12,23,vou,1673852,327980,1345872
2010-12-12,0,cm,922865,6993984,-6071119
2010-12-12,1,cm,3603368,4074355,-470987
2010-12-12,2,cm,4308903,7049636,-2740733
2010-12-12,3,cm,6703442,2287559,4415883
2010-12-12,4,cm,8370788,5154559,3216229
2010-12-12,5,cm,3254204,7692785,-4438581
2010-12-12,6,cm,4803314,6229684,-1426370
2010-12-12,7,cm,9806976,8385655,1421321
2010-12-12,8,cm,6688974,6398010,290964
2010-12-12,9,cm,4826402,469520,4356882
2010-12-12,10,cm,2967672,2700294,267378
2010-12-12,11,cm,6412353,4916510,1495843
2010-12-12,12,cm,2662050,1069211,1592839
2010-12-12,13,cm,6816313,2539431,4276882
2010-12-12,14,cm,5026636,6396219,-1369583
2010-12-12,15,cm,6159992,6140815,19177
2010-12-12,16,cm,7744212,7657549,86663
2010-12-12,17,cm,2233628,4603491,-2369863
2010-12-12,18,cm,1349643,9486025,-8136382
2010-12-12,19,cm,9769177,1733493,8035684
2010-12-12,20,cm,11087,2491140,-2480053
2010-12-12,21,cm,1888813,5038476,-3149663
2010-12-12,22,cm,6900760,146381,6754379
2010-12-12,23,cm,5930813,5163279,767534
2010-12-12,0,adj,1103322,4372654,-3269332
2010-12-12,1,adj,3432290,8839350,-5407060
2010-12-12,2,adj,8391869,5105600,3286269
2010-12-12,3,adj,4897237,6129955,-1232718
2010-12-12,4,adj,6724375,5723911,1000464
2010-12-12,5,adj,7672350,8710517,-1038167
2010-12-12,6,adj,8058907,2293363,5765544
2010-12-12,7,adj,7485656,2776014,4709642
2010-12-12,8,adj,2181784,5090166,-2908382
2010-12-12,9,adj,4329606,9415992,-5086386
2010-12-12,10,adj,7065005,3342004,3723001
2010-12-12,11,adj,9828020,7873105,1954915
2010-12-12,12,adj,9911546,7526486,2385060
2010-12-12,13,adj,5583553,247025,5336528
2010-12-12,14,adj,274129,8539717,-8265588
2010-12-12,15,adj,1035724,8582324,-7546600
2010-12-12,16,adj,5278955,738444,4540511
2010-12-12,17,adj,2622894,1163102,1459792
2010-12-12,18,adj,2510153,7120159,-4610006
2010-12-12,19,adj,4794691,2992918,1801773
2010-12-12,20,adj,7528297,9806528,-2278231
2010-12-12,21,adj,4843472,3649223,1194249
2010-12-12,22,adj,1059721,9783672,-8723951
2010-12-12,23,adj,1413436,7400696,-5987260
2010-12-12,0,first,8007784,6276745,1731039
2010-12-12,1,first,3942377,7452459,-3510082
2010-12-12,2,first,2567498,4919087,-2351589
2010-12-12,3,first,4741137,9887207,-5146070
2010-12-12,4,first,7024480,9094996,-2070516
2010-12-12,5,first,2924969,9308203,-6383234
2010-12-12,6,first,3696664,2510059,1186605
2010-12-12,7,first,2745069,460034,2285035
2010-12-12,8,first,5503152,4357710,1145442
2010-12-12,9,first,9174926,3272249,5902677
2010-12-12,10,first,5273909,6300957,-1027048
2010-12-12,11,first,323802,402210,-78408
2010-12-12,12,first,9453628,3374886,6078742
2010-12-12,13,first,5600932,1195960,4404972
2010-12-12,14,first,8093388,9337814,-1244426
2010-12-12,15,first,8724741,2901380,5823361
2010-12-12,16,first,3188826,548301,2640525
2010-12-12,17,first,4288238,6627270,-2339032
2010-12-12,18,first,4411021,7832277,-3421256
2010-12-12,19,first,5150983,8325863,-3174880
2010-12-12,20,first,6464821,5993533,471288
2010-12-12,21,first,3077325,7498581,-4421256
2010-12-12,22,first,464771,3669725,-3204954
2010-12-12,23,first,5036004,1577934,3458070
2010-12-12,0,mon,9420109,3374117,6045992
2010-12-12,1,mon,8764713,7425092,1339621
2010-12-12,2,mon,7530162,5710752,1819410
2010-12-12,3,mon,1676079,1378877,297202
2010-12-12,4,mon,2837154,9526998,-6689844
2010-12-12,5,mon,2333501,4003995,-1670494
2010-12-12,6,mon,7469343,6171275,1298068
2010-12-12,7,mon,497011,9046312,-8549301
2010-12-12,8,mon,6002800,6833797,-830997
2010-12-12,9,mon,4012855,9779070,-5766215
2010-12-12,10,mon,574187,9898114,-9323927
2010-12-12,11,mon,8665710,6096141,2569569
2010-12-12,12,mon,9218736,8558588,660148
2010-12-12,13,mon,9628682,6238040,3390642
2010-12-12,14,mon,4739832,8085384,-3345552
2010-12-12,15,mon,7822951,3409420,4413531
2010-12-12,16,mon,4181966,6093628,-1911662
2010-12-12,17,mon,7295742,1192993,6102749
2010-12-12,18,mon,2312211,5817174,-3504963
2010-12-12,19,mon,28092,8758692,-8730600
2010-12-12,20,mon,4218978,7627967,-3408989
2010-12-12,21,mon,1131356,3622240,-2490884
2010-12-12,22,mon,6052515,7955295,-1902780
2010-12-12,23,mon,7464752,5547056,1917696
2010-12-12,0,data,2884495,6167214,-3282719
2010-12-12,1,data,1277326,8889637,-7612311
2010-12-12,2,data,6859308,6552366,306942
2010-12-12,3,data,5428093,1592938,3835155
2010-12-12,4,data,2329214,9971640,-7642426
2010-12-12,5,data,5405852,5896130,-490278
2010-12-12,6,data,8496897,3377625,5119272
2010-12-12,7,data,555253,8416390,-7861137
2010-12-12,8,data,745094,2456637,-1711543
2010-12-12,9,data,9374950,2608962,6765988
2010-12-12,10,data,545025,3939470,-3394445
2010-12-12,11,data,4097977,1260263,2837714
2010-12-12,12,data,5594762,3534204,2060558
2010-12-12,13,data,6571942,9465180,-2893238
2010-12-12,14,data,7801219,5499614,2301605
2010-12-12,15,data,4612782,3732284,880498
2010-12-12,16,data,5777474,2677079,3100395
2010-12-12,17,data,7346802,1181336,6165466
2010-12-12,18,data,1202952,4900935,-3697983
2010-12-12,19,data,3086515,2220324,866191
2010-12-12,20,data,5457319,1003192,4454127
2010-12-12,21,data,1756342,3979320,-2222978
2010-12-12,22,data,2010583,3650603,-1640020
2010-12-12,23,data,986449,4745420,-3758971
2010-12-12,0,voice,758569,9691317,-8932748
2010-12-12,1,voice,3617402,7072918,-3455516
2010-12-12,2,voice,3182184,3951941,-769757
2010-12-12,3,voice,343535,2662444,-2318909
2010-12-12,4,voice,4380623,6342586,-1961963
2010-12-12,5,voice,7116600,2165203,4951397
2010-12-12,6,voice,9168682,7548626,1620056
2010-12-12,7,voice,1165409,5764350,-4598941
2010-12-12,8,voice,6923410,213622,6709788
2010-12-12,9,voice,123985,81875,42110
2010-12-12,10,voice,9440130,179648,9260482
2010-12-12,11,voice,4041233,8302162,-4260929
2010-12-12,12,voice,7508719,4789562,2719157
2010-12-12,13,voice,8238965,4572262,3666703
2010-12-12,14,voice,4775666,5573712,-798046
2010-12-12,15,voice,6472223,791608,5680615
2010-12-12,16,voice,647364,73485,573879
2010-12-12,17,voice,9020501,1562334,7458167
2010-12-12,18,voice,4970978,8558771,-3587793
2010-12-12,19,voice,4344523,4363359,-18836
2010-12-12,20,voice,9813078,3759120,6053958
2010-12-12,21,voice,2045617,2965678,-920061
2010-12-12,22,voice,8014917,17272,7997645
2010-12-12,23,voice,7573716,7951933,-378217
2010-12-12,0,sms,220982,4281381,-4060399
2010-12-12,1,sms,6815406,6780833,34573
2010-12-12,2,sms,2259266,9969172,-7709906
2010-12-12,3,sms,5323716,4998089,325627
2010-12-12,4,sms,3735447,7757312,-4021865
2010-12-12,5,sms,6696184,3278566,3417618
2010-12-12,6,sms,534825,2481362,-1946537
2010-12-12,7,sms,302836,79083,223753
2010-12-12,8,sms,4610451,5792569,-1182118
2010-12-12,9,sms,8578880,7760937,817943
2010-12-12,10,sms,9187238,9793311,-606073
2010-12-12,11,sms,7708953,8261629,-552676
2010-12-12,12,sms,4663224,2396843,2266381
2010-12-12,13,sms,3476917,3079975,396942
2010-12-12,14,sms,1969933,6242081,-4272148
2010-12-12,15,sms,5740912,5020718,720194
2010-12-12,16,sms,8750396,9244843,-494447
2010-12-12,17,sms,8944877,8031770,913107
2010-12-12,18,sms,6847174,9878031,-3030857
2010-12-12,19,sms,3305101,3888020,-582919
2010-12-12,20,sms,6554070,8405342,-1851272
2010-12-12,21,sms,5609060,7965197,-2356137
2010-12-12,22,sms,6664361,5328000,1336361
2010-12-12,23,sms,5540305,7375940,-1835635
2010-12-12,0,clr,8625985,8563148,62837
2010-12-12,1,clr,116498,4195145,-4078647
2010-12-12,2,clr,537322,5908987,-5371665
2010-12-12,3,clr,2531273,6248453,-3717180
2010-12-12,4,clr,2800910,4936146,-2135236
2010-12-12,5,clr,1334392,4276654,-2942262
2010-12-12,6,clr,4208027,3890479,317548
2010-12-12,7,clr,7956220,7635500,320720
2010-12-12,8,clr,6179212,725468,5453744
2010-12-12,9,clr,2018904,9305092,-7286188
2010-12-12,10,clr,2776695,2764739,11956
2010-12-12,11,clr,7393273,217004,7176269
2010-12-12,12,clr,6321792,8994753,-2672961
2010-12-12,13,clr,3099913,8259163,-5159250
2010-12-12,14,clr,439954,3440612,-3000658
2010-12-12,15,clr,9250004,4735866,4514138
2010-12-12,16,clr,8539259,5359700,3179559
2010-12-12,17,clr,3788367,3649772,138595
2010-12-12,18,clr,6717020,5939258,777762
2010-12-12,19,clr,7841000,618648,7222352
2010-12-12,20,clr,1963907,996463,967444
2010-12-12,21,clr,3383018,4862453,-1479435
2010-12-12,22,clr,4462395,1549434,2912961
2010-12-12,23,clr,7262986,3356982,3906004
2010-12-13,0,com,2165280,5116292,-2951012
2010-12-13,1,com,2015595,5526078,-3510483
2010-12-13,2,com,1118128,6257508,-5139380
2010-12-13,3,com,1028908,2829012,-1800104
2010-12-13,4,com,5906710,5419562,487148
2010-12-13,5,com,3086392,2506472,579920
2010-12-13,6,com,1329990,748837,581153
2010-12-13,7,com,6881715,358850,6522865
2010-12-13,8,com,7079257,6469496,609761
2010-12-13,9,com,6853024,4315953,2537071
2010-12-13,10,com,7651217,9098270,-1447053
2010-12-13,11,com,9528035,8096841,1431194
2010-12-13,12,com,3209964,2040479,1169485
2010-12-13,13,com,5693845,1553829,4140016
2010-12-13,14,com,4814695,6870794,-2056099
2010-12-13,15,com,1233401,2087290,-853889
2010-12-13,16,com,3979836,1042033,2937803
2010-12-13,17,com,6777774,6606921,170853
2010-12-13,18,com,2354042,7519200,-5165158
2010-12-13,19,com,8435598,3334820,5100778
2010-12-13,20,com,6481558,3674646,2806912
2010-12-13,21,com,3094084,9649089,-6555005
2010-12-13,22,com,3003062,174928,2828134
2010-12-13,23,com,4115076,566548,3548528
2010-12-13,0,vou,1949211,5899060,-3949849
2010-12-13,1,vou,2234916,1648237,586679
2010-12-13,2,vou,4784464,4780326,4138
2010-12-13,3,vou,5132782,7057984,-1925202
2010-12-13,4,vou,5670773,63054,5607719
2010-12-13,5,vou,3942846,4526555,-583709
2010-12-13,6,vou,6926634,5697526,1229108
2010-12-13,7,vou,2987924,3251178,-263254
2010-12-13,8,vou,1671890,1023035,648855
2010-12-13,9,vou,9218027,1413471,7804556
2010-12-13,10,vou,4665995,4443302,222693
2010-12-13,11,vou,79497,7905636,-7826139
2010-12-13,12,vou,2376418,7297787,-4921369
2010-12-13,13,vou,4883100,3919241,963859
2010-12-13,14,vou,2671942,7712230,-5040288
2010-12-13,15,vou,1034463,66515,967948
2010-12-13,16,vou,9008931,2305752,6703179
2010-12-13,17,vou,4624746,5097946,-473200
2010-12-13,18,vou,2593475,1008030,1585445
2010-12-13,19,vou,2623123,6135541,-3512418
2010-12-13,20,vou,181613,3402987,-3221374
2010-12-13,21,vou,5621128,8786226,-3165098
2010-12-13,22,vou,2227870,2070177,157693
2010-12-13,23,vou,9867434,142768,9724666
2010-12-13,0,cm,2601558,3589052,-987494
2010-12-13,1,cm,5196737,8946330,-3749593
2010-12-13,2,cm,5340389,375179,4965210
2010-12-13,3,cm,8373095,1714681,6658414
2010-12-13,4,cm,9819011,4873486,4945525
2010-12-13,5,cm,9722713,6486052,3236661
2010-12-13,6,cm,5143879,2978496,2165383
2010-12-13,7,cm,9229439,4514949,4714490
2010-12-13,8,cm,9406051,7227136,2178915
2010-12-13,9,cm,2541695,2301095,240600
2010-12-13,10,cm,3960536,6903352,-2942816
2010-12-13,11,cm,5473479,794338,4679141
2010-12-13,12,cm,1723992,8367157,-6643165
2010-12-13,13,cm,1673596,984347,689249
2010-12-13,14,cm,7579489,1273128,6306361
2010-12-13,15,cm,9737140,652640,9084500
2010-12-13,16,cm,5709858,3377533,2332325
2010-12-13,17,cm,8585006,8839893,-254887
2010-12-13,18,cm,8144902,4031506,4113396
2010-12-13,19,cm,5203062,5802708,-599646
2010-12-13,20,cm,8585219,9799620,-1214401
2010-12-13,21,cm,3746156,2324261,1421895
2010-12-13,22,cm,1788749,6445444,-4656695
2010-12-13,23,cm,1576761,8180985,-6604224
2010-12-13,0,adj,4404366,4587654,-183288
2010-12-13,1,adj,9793239,1271545,8521694
2010-12-13,2,adj,1223905,7845173,-6621268
2010-12-13,3,adj,6495296,7232951,-737655
2010-12-13,4,adj,4858096,7412064,-2553968
2010-12-13,5,adj,6934998,4573101,2361897
2010-12-13,6,adj,5485055,309692,5175363
2010-12-13,7,adj,9499754,17529,9482225
2010-12-13,8,adj,4969577,7477728,-2508151
2010-12-13,9,adj,6846707,6599653,247054
2010-12-13,10,adj,729797,4906111,-4176314
2010-12-13,11,adj,8379061,1560833,6818228
2010-12-13,12,adj,2583413,7705978,-5122565
2010-12-13,13,adj,1795882,8790869,-6994987
2010-12-13,14,adj,9783614,4025832,5757782
2010-12-13,15,adj,2642870,9719445,-7076575
2010-12-13,16,adj,9580155,4948488,4631667
2010-12-13,17,adj,6466250,2311338,4154912
2010-12-13,18,adj,6972814,2671189,4301625
2010-12-13,19,adj,2871860,5145315,-2273455
2010-12-13,20,adj,7610638,3178687,4431951
2010-12-13,21,adj,9043449,9289755,-246306
2010-12-13,22,adj,5516655,6207429,-690774
2010-12-13,23,adj,7539882,3669239,3870643
2010-12-13,0,first,2264129,6164093,-3899964
2010-12-13,1,first,574734,4979629,-4404895
2010-12-13,2,first,9604078,844892,8759186
2010-12-13,3,first,6688612,6570542,118070
2010-12-13,4,first,2039963,5752628,-3712665
2010-12-13,5,first,3148106,935176,2212930
2010-12-13,6,first,8496957,2109077,6387880
2010-12-13,7,first,2109109,3875793,-1766684
2010-12-13,8,first,7407750,1062598,6345152
2010-12-13,9,first,8761267,4717260,4044007
2010-12-13,10,first,4562359,8775190,-4212831
2010-12-13,11,first,6927466,3651133,3276333
2010-12-13,12,first,7734569,4186088,3548481
2010-12-13,13,first,1050210,5031334,-3981124
2010-12-13,14,first,4374653,9596717,-5222064
2010-12-13,15,first,7574612,3847704,3726908
2010-12-13,16,first,2233053,9612033,-7378980
2010-12-13,17,first,2799804,4021178,-1221374
2010-12-13,18,first,4391335,4855285,-463950
2010-12-13,19,first,8733392,1057178,7676214
2010-12-13,20,first,9049185,7030052,2019133
2010-12-13,21,first,9214023,6575359,2638664
2010-12-13,22,first,3614534,5177157,-1562623
2010-12-13,23,first,8056389,321259,7735130
2010-12-13,0,mon,3498526,3774885,-276359
2010-12-13,1,mon,290471,7294193,-7003722
2010-12-13,2,mon,3032850,8510376,-5477526
2010-12-13,3,mon,1532439,2013040,-480601
2010-12-13,4,mon,2379193,6599090,-4219897
2010-12-13,5,mon,5206776,3366326,1840450
2010-12-13,6,mon,5544257,578243,4966014
2010-12-13,7,mon,5331862,6404601,-1072739
2010-12-13,8,mon,7662126,4484442,3177684
2010-12-13,9,mon,5015594,2752776,2262818
2010-12-13,10,mon,495512,8620920,-8125408
2010-12-13,11,mon,3886034,2084898,1801136
2010-12-13,12,mon,136149,9815801,-9679652
2010-12-13,13,mon,3943569,5364555,-1420986
2010-12-13,14,mon,4488306,1810258,2678048
2010-12-13,15,mon,5743283,6313382,-570099
2010-12-13,16,mon,7937054,5039083,2897971
2010-12-13,17,mon,3483935,6858007,-3374072
2010-12-13,18,mon,5737399,767784,4969615
2010-12-13,19,mon,9382601,2895528,6487073
2010-12-13,20,mon,9312817,5501396,3811421
2010-12-13,21,mon,2684602,4377,2680225
2010-12-13,22,mon,3629186,9753451,-6124265
2010-12-13,23,mon,2782068,5838565,-3056497
2010-12-13,0,data,1896148,717449,1178699
2010-12-13,1,data,8249446,3164287,5085159
2010-12-13,2,data,2833102,5091627,-2258525
2010-12-13,3,data,9633928,6222318,3411610
2010-12-13,4,data,6766077,1249695,5516382
2010-12-13,5,data,2228586,8892603,-6664017
2010-12-13,6,data,5424320,7456152,-2031832
2010-12-13,7,data,2420703,3329139,-908436
2010-12-13,8,data,8498922,3634068,4864854
2010-12-13,9,data,7837065,4087137,3749928
2010-12-13,10,data,513043,7104693,-6591650
2010-12-13,11,data,6168272,6525671,-357399
2010-12-13,12,data,9605345,1375600,8229745
2010-12-13,13,data,204067,8672233,-8468166
2010-12-13,14,data,7784925,1330349,6454576
2010-12-13,15,data,9288037,8767853,520184
2010-12-13,16,data,9486513,4191486,5295027
2010-12-13,17,data,1194051,6329584,-5135533
2010-12-13,18,data,4510388,9290491,-4780103
2010-12-13,19,data,4750112,524756,4225356
2010-12-13,20,data,112946,936304,-823358
2010-12-13,21,data,7338281,9500940,-2162659
2010-12-13,22,data,2324736,7611263,-5286527
2010-12-13,23,data,9770655,3781008,5989647
2010-12-13,0,voice,8542332,9667939,-1125607
2010-12-13,1,voice,8293010,8968681,-675671
2010-12-13,2,voice,4200451,7334585,-3134134
2010-12-13,3,voice,6907223,1177826,5729397
2010-12-13,4,voice,2873100,7914216,-5041116
2010-12-13,5,voice,3465937,3578933,-112996
2010-12-13,6,voice,5523841,2435429,3088412
2010-12-13,7,voice,866871,4934251,-4067380
2010-12-13,8,voice,7900268,3742414,4157854
2010-12-13,9,voice,813763,2819845,-2006082
2010-12-13,10,voice,6743329,4655370,2087959
2010-12-13,11,voice,1164656,4883675,-3719019
2010-12-13,12,voice,8810259,2890536,5919723
2010-12-13,13,voice,3319899,8899517,-5579618
2010-12-13,14,voice,2389718,3047655,-657937
2010-12-13,15,voice,7964740,9165418,-1200678
2010-12-13,16,voice,7027819,206099,6821720
2010-12-13,17,voice,4406273,1428404,2977869
2010-12-13,18,voice,4594704,4516025,78679
2010-12-13,19,voice,3048558,7968733,-4920175
2010-12-13,20,voice,3216631,2326851,889780
2010-12-13,21,voice,9638525,278740,9359785
2010-12-13,22,voice,8220904,677531,7543373
2010-12-13,23,voice,2129779,3841488,-1711709
2010-12-13,0,sms,5153343,7350485,-2197142
2010-12-13,1,sms,4248228,440182,3808046
2010-12-13,2,sms,7740894,924608,6816286
2010-12-13,3,sms,9153543,7505483,1648060
2010-12-13,4,sms,1475977,549162,926815
2010-12-13,5,sms,2761843,3463234,-701391
2010-12-13,6,sms,619377,5625752,-5006375
2010-12-13,7,sms,9050763,696727,8354036
2010-12-13,8,sms,6822492,2462526,4359966
2010-12-13,9,sms,5636928,8875923,-3238995
2010-12-13,10,sms,7100585,1648092,5452493
2010-12-13,11,sms,771886,5032170,-4260284
2010-12-13,12,sms,6840006,8827093,-1987087
2010-12-13,13,sms,8977800,4143030,4834770
2010-12-13,14,sms,3873723,2502073,1371650
2010-12-13,15,sms,1734794,4884213,-3149419
2010-12-13,16,sms,4142959,8890570,-4747611
2010-12-13,17,sms,9382248,9484007,-101759
2010-12-13,18,sms,1134538,166804,967734
2010-12-13,19,sms,4606732,4970198,-363466
2010-12-13,20,sms,2395043,5818295,-3423252
2010-12-13,21,sms,1956604,656583,1300021
2010-12-13,22,sms,5159641,1668790,3490851
2010-12-13,23,sms,4267252,7909365,-3642113
2010-12-13,0,clr,6700023,2546028,4153995
2010-12-13,1,clr,5435030,9413048,-3978018
2010-12-13,2,clr,9940000,1065233,8874767
2010-12-13,3,clr,9922999,2516043,7406956
2010-12-13,4,clr,4304964,6475920,-2170956
2010-12-13,5,clr,9330944,4427569,4903375
2010-12-13,6,clr,1426965,8468739,-7041774
2010-12-13,7,clr,2820866,8325800,-5504934
2010-12-13,8,clr,7306800,9711684,-2404884
2010-12-13,9,clr,6771608,6375677,395931
2010-12-13,10,clr,175232,4444064,-4268832
2010-12-13,11,clr,6068572,2622826,3445746
2010-12-13,12,clr,2322208,1326475,995733
2010-12-13,13,clr,5871963,602719,5269244
2010-12-13,14,clr,251447,8381108,-8129661
2010-12-13,15,clr,5342225,7623052,-2280827
2010-12-13,16,clr,9729140,9252311,476829
2010-12-13,17,clr,7569947,633961,6935986
2010-12-13,18,clr,7238551,2691306,4547245
2010-12-13,19,clr,8109781,9137555,-1027774
2010-12-13,20,clr,5225603,4818415,407188
2010-12-13,21,clr,6403938,1216006,5187932
2010-12-13,22,clr,2217533,9568856,-7351323
2010-12-13,23,clr,6368444,2167299,4201145
2010-12-14,0,com,4693782,8749000,-4055218
2010-12-14,1,com,6575783,5816670,759113
2010-12-14,2,com,6135716,19370,6116346
2010-12-14,3,com,8203370,7456893,746477
2010-12-14,4,com,4090888,1252131,2838757
2010-12-14,5,com,3289807,5323609,-2033802
2010-12-14,6,com,6403225,9930376,-3527151
2010-12-14,7,com,8181420,8305307,-123887
2010-12-14,8,com,6143144,7347782,-1204638
2010-12-14,9,com,9767084,2166752,7600332
2010-12-14,10,com,8397180,3105419,5291761
2010-12-14,11,com,4099054,4253371,-154317
2010-12-14,12,com,6602945,5259550,1343395
2010-12-14,13,com,5128477,1780566,3347911
2010-12-14,14,com,873113,7297302,-6424189
2010-12-14,15,com,4399547,74500,4325047
2010-12-14,16,com,7287270,8112746,-825476
2010-12-14,17,com,5282057,2018583,3263474
2010-12-14,18,com,4392381,4643155,-250774
2010-12-14,19,com,607902,4987602,-4379700
2010-12-14,20,com,5126004,2053439,3072565
2010-12-14,21,com,7497106,5670737,1826369
2010-12-14,22,com,7519494,7236211,283283
2010-12-14,23,com,4889954,5391709,-501755
2010-12-14,0,vou,3604036,985612,2618424
2010-12-14,1,vou,6051907,2647526,3404381
2010-12-14,2,vou,188864,1763231,-1574367
2010-12-14,3,vou,8321581,9340707,-1019126
2010-12-14,4,vou,708022,7030391,-6322369
2010-12-14,5,vou,9883315,8405427,1477888
2010-12-14,6,vou,7674181,541404,7132777
2010-12-14,7,vou,1358899,6989865,-5630966
2010-12-14,8,vou,3787028,4233070,-446042
2010-12-14,9,vou,7043843,5882734,1161109
2010-12-14,10,vou,9501956,5590016,3911940
2010-12-14,11,vou,260046,5049230,-4789184
2010-12-14,12,vou,3019331,767414,2251917
2010-12-14,13,vou,367079,5143328,-4776249
2010-12-14,14,vou,704342,8951218,-8246876
2010-12-14,15,vou,5096794,3186664,1910130
2010-12-14,16,vou,7225048,599643,6625405
2010-12-14,17,vou,921882,9414642,-8492760
2010-12-14,18,vou,6048625,7448090,-1399465
2010-12-14,19,vou,6041361,8846060,-2804699
2010-12-14,20,vou,52907,3529378,-3476471
2010-12-14,21,vou,3707906,6846197,-3138291
2010-12-14,22,vou,7376256,921564,6454692
2010-12-14,23,vou,5530016,5938126,-408110
2010-12-14,0,cm,3934115,3124370,809745
2010-12-14,1,cm,9034041,6437383,2596658
2010-12-14,2,cm,1271643,9160230,-7888587
2010-12-14,3,cm,6823528,8199541,-1376013
2010-12-14,4,cm,1672556,9400486,-7727930
2010-12-14,5,cm,1509767,4362923,-2853156
2010-12-14,6,cm,7513779,5820665,1693114
2010-12-14,7,cm,2407215,5515792,-3108577
2010-12-14,8,cm,1488443,1046820,441623
2010-12-14,9,cm,2923247,109521,2813726
2010-12-14,10,cm,1907620,9877416,-7969796
2010-12-14,11,cm,7465111,835685,6629426
2010-12-14,12,cm,3370459,1900495,1469964
2010-12-14,13,cm,550005,1932478,-1382473
2010-12-14,14,cm,1148551,9361441,-8212890
2010-12-14,15,cm,6234985,1275052,4959933
2010-12-14,16,cm,1754906,4536506,-2781600
2010-12-14,17,cm,1891755,8978374,-7086619
2010-12-14,18,cm,4257170,1859336,2397834
2010-12-14,19,cm,4806603,180966,4625637
2010-12-14,20,cm,8279538,2525929,5753609
2010-12-14,21,cm,5062983,7778825,-2715842
2010-12-14,22,cm,6899871,2287041,4612830
2010-12-14,23,cm,4215694,652853,3562841
2010-12-14,0,adj,477066,5586202,-5109136
2010-12-14,1,adj,9811922,6229316,3582606
2010-12-14,2,adj,2239429,4281436,-2042007
2010-12-14,3,adj,431758,5139199,-4707441
2010-12-14,4,adj,7425427,289670,7135757
2010-12-14,5,adj,6404033,6316243,87790
2010-12-14,6,adj,3375467,4825836,-1450369
2010-12-14,7,adj,8057277,3603009,4454268
2010-12-14,8,adj,1372187,7844137,-6471950
2010-12-14,9,adj,9042900,892441,8150459
2010-12-14,10,adj,4973683,3103607,1870076
2010-12-14,11,adj,4377432,9475179,-5097747
2010-12-14,12,adj,1238442,2739122,-1500680
2010-12-14,13,adj,1122373,5857918,-4735545
2010-12-14,14,adj,6747029,243840,6503189
2010-12-14,15,adj,3061725,2203722,858003
2010-12-14,16,adj,7491899,1836985,5654914
2010-12-14,17,adj,4190916,1633700,2557216
2010-12-14,18,adj,2613088,1580371,1032717
2010-12-14,19,adj,2625962,9360007,-6734045
2010-12-14,20,adj,2705958,1051254,1654704
2010-12-14,21,adj,7024699,7020493,4206
2010-12-14,22,adj,2658905,1722128,936777
2010-12-14,23,adj,2847021,6204229,-3357208
2010-12-14,0,first,6358995,8165372,-1806377
2010-12-14,1,first,8972256,9686488,-714232
2010-12-14,2,first,8879462,5922868,2956594
2010-12-14,3,first,4247281,7307638,-3060357
2010-12-14,4,first,4111881,8413577,-4301696
2010-12-14,5,first,2026268,2897681,-871413
2010-12-14,6,first,5815551,5587449,228102
2010-12-14,7,first,3854927,7981219,-4126292
2010-12-14,8,first,1140484,3201532,-2061048
2010-12-14,9,first,9476397,5452408,4023989
2010-12-14,10,first,2882959,2266034,616925
2010-12-14,11,first,9324123,9677888,-353765
2010-12-14,12,first,8771620,9051533,-279913
2010-12-14,13,first,7439194,920607,6518587
2010-12-14,14,first,332357,7604342,-7271985
2010-12-14,15,first,2688376,520357,2168019
2010-12-14,16,first,9376352,5500309,3876043
2010-12-14,17,first,4362479,205966,4156513
2010-12-14,18,first,9535430,8544252,991178
2010-12-14,19,first,8894201,6151784,2742417
2010-12-14,20,first,4989550,2795537,2194013
2010-12-14,21,first,7126068,8658135,-1532067
2010-12-14,22,first,6335937,7611067,-1275130
2010-12-14,23,first,2816756,7235619,-4418863
2010-12-14,0,mon,658680,1582535,-923855
2010-12-14,1,mon,1779958,80020,1699938
2010-12-14,2,mon,3407961,8304131,-4896170
2010-12-14,3,mon,3768272,8384538,-4616266
2010-12-14,4,mon,985446,4814873,-3829427
2010-12-14,5,mon,6369894,7594566,-1224672
2010-12-14,6,mon,4270918,5535202,-1264284
2010-12-14,7,mon,8569883,5009599,3560284
2010-12-14,8,mon,297531,7512272,-7214741
2010-12-14,9,mon,733048,4641965,-3908917
2010-12-14,10,mon,2118031,5798129,-3680098
2010-12-14,11,mon,655765,6805505,-6149740
2010-12-14,12,mon,2586941,6399888,-3812947
2010-12-14,13,mon,5586175,7571437,-1985262
2010-12-14,14,mon,7154299,1985967,5168332
2010-12-14,15,mon,2380454,7161769,-4781315
2010-12-14,16,mon,4701474,1238893,3462581
2010-12-14,17,mon,1645170,2112724,-467554
2010-12-14,18,mon,2623327,3380028,-756701
2010-12-14,19,mon,8788451,639627,8148824
2010-12-14,20,mon,1318741,3014455,-1695714
2010-12-14,21,mon,6941758,2146796,4794962
2010-12-14,22,mon,7786398,1170351,6616047
2010-12-14,23,mon,4496913,9034864,-4537951
2010-12-14,0,data,748260,7149112,-6400852
2010-12-14,1,data,3095902,6487717,-3391815
2010-12-14,2,data,5340018,8324586,-2984568
2010-12-14,3,data,337098,3974096,-3636998
2010-12-14,4,data,7182742,2781928,4400814
2010-12-14,5,data,2176100,4731809,-2555709
2010-12-14,6,data,4106711,1257089,2849622
2010-12-14,7,data,5860003,3554361,2305642
2010-12-14,8,data,3510796,925495,2585301
2010-12-14,9,data,2982652,9689722,-6707070
2010-12-14,10,data,2120802,8311405,-6190603
2010-12-14,11,data,2013168,4669835,-2656667
2010-12-14,12,data,2054214,4935827,-2881613
2010-12-14,13,data,5632708,4438045,1194663
2010-12-14,14,data,1565787,6202625,-4636838
2010-12-14,15,data,3854181,3632773,221408
2010-12-14,16,data,2251540,5016361,-2764821
2010-12-14,17,data,9394398,338778,9055620
2010-12-14,18,data,7879818,5188928,2690890
2010-12-14,19,data,701948,1052006,-350058
2010-12-14,20,data,8371577,5051882,3319695
2010-12-14,21,data,811806,7128556,-6316750
2010-12-14,22,data,1976696,2074014,-97318
2010-12-14,23,data,4181851,5326529,-1144678
2010-12-14,0,voice,8291365,1539095,6752270
2010-12-14,1,voice,3163540,1484796,1678744
2010-12-14,2,voice,8588110,6492887,2095223
2010-12-14,3,voice,5542708,9947432,-4404724
2010-12-14,4,voice,1532196,9716124,-8183928
2010-12-14,5,voice,8885580,7948517,937063
2010-12-14,6,voice,5102483,7705147,-2602664
2010-12-14,7,voice,1760822,4974840,-3214018
2010-12-14,8,voice,2854536,8381844,-5527308
2010-12-14,9,voice,5992663,5503986,488677
2010-12-14,10,voice,6648375,9864785,-3216410
2010-12-14,11,voice,7407616,8579824,-1172208
2010-12-14,12,voice,7831714,850367,6981347
2010-12-14,13,voice,2651084,1493991,1157093
2010-12-14,14,voice,5188399,8868849,-3680450
2010-12-14,15,voice,9903072,273247,9629825
2010-12-14,16,voice,8589141,4328278,4260863
2010-12-14,17,voice,8935493,9488203,-552710
2010-12-14,18,voice,4768443,1162273,3606170
2010-12-14,19,voice,3240638,8890680,-5650042
2010-12-14,20,voice,903273,7499682,-6596409
2010-12-14,21,voice,7422818,7063448,359370
2010-12-14,22,voice,7415951,6660343,755608
2010-12-14,23,voice,1148571,1500675,-352104
2010-12-14,0,sms,957684,4755394,-3797710
2010-12-14,1,sms,9945888,9208758,737130
2010-12-14,2,sms,6456955,1327660,5129295
2010-12-14,3,sms,6940945,5911344,1029601
2010-12-14,4,sms,1308792,2956168,-1647376
2010-12-14,5,sms,321379,5150784,-4829405
2010-12-14,6,sms,4897116,2439006,2458110
2010-12-14,7,sms,6345347,4313999,2031348
2010-12-14,8,sms,7925985,5641458,2284527
2010-12-14,9,sms,3270716,586166,2684550
2010-12-14,10,sms,2386895,1080150,1306745
2010-12-14,11,sms,8896264,9749563,-853299
2010-12-14,12,sms,5175463,376001,4799462
2010-12-14,13,sms,432815,6869871,-6437056
2010-12-14,14,sms,4652623,8657196,-4004573
2010-12-14,15,sms,5172330,1414201,3758129
2010-12-14,16,sms,6948785,2951881,3996904
2010-12-14,17,sms,9555888,5083744,4472144
2010-12-14,18,sms,5981879,931886,5049993
2010-12-14,19,sms,659852,1310324,-650472
2010-12-14,20,sms,7154174,4709164,2445010
2010-12-14,21,sms,5003167,8048737,-3045570
2010-12-14,22,sms,6289522,2600010,3689512
2010-12-14,23,sms,3527536,4979834,-1452298
2010-12-14,0,clr,1141346,6166268,-5024922
2010-12-14,1,clr,8747392,4971355,3776037
2010-12-14,2,clr,4594005,1974776,2619229
2010-12-14,3,clr,1133749,5282921,-4149172
2010-12-14,4,clr,9110999,4422915,4688084
2010-12-14,5,clr,9559116,3769148,5789968
2010-12-14,6,clr,27425,3445625,-3418200
2010-12-14,7,clr,1021710,7449300,-6427590
2010-12-14,8,clr,9568317,4906671,4661646
2010-12-14,9,clr,3446910,2149253,1297657
2010-12-14,10,clr,1731738,5403326,-3671588
2010-12-14,11,clr,6595765,5031557,1564208
2010-12-14,12,clr,3869191,2889206,979985
2010-12-14,13,clr,2232163,7336812,-5104649
2010-12-14,14,clr,5812920,2475743,3337177
2010-12-14,15,clr,1037405,3201614,-2164209
2010-12-14,16,clr,5946130,4780359,1165771
2010-12-14,17,clr,2668686,9042054,-6373368
2010-12-14,18,clr,4008898,2164315,1844583
2010-12-14,19,clr,9546312,5545558,4000754
2010-12-14,20,clr,3213586,1214213,1999373
2010-12-14,21,clr,1268195,6093421,-4825226
2010-12-14,22,clr,160170,7161892,-7001722
2010-12-14,23,clr,9022462,302063,8720399
2010-12-15,0,com,3080124,9598709,-6518585
2010-12-15,1,com,5488859,4999849,489010
2010-12-15,2,com,3192951,4828322,-1635371
2010-12-15,3,com,9971334,8286650,1684684
2010-12-15,4,com,6496966,8401444,-1904478
2010-12-15,5,com,6661112,4141484,2519628
2010-12-15,6,com,9344207,103082,9241125
2010-12-15,7,com,8725927,226959,8498968
2010-12-15,8,com,1247489,4992936,-3745447
2010-12-15,9,com,6191107,6732316,-541209
2010-12-15,10,com,9885372,6857625,3027747
2010-12-15,11,com,6333187,9270894,-2937707
2010-12-15,12,com,7910194,5372669,2537525
2010-12-15,13,com,9722487,8442885,1279602
2010-12-15,14,com,2805828,2940755,-134927
2010-12-15,15,com,2043563,6870687,-4827124
2010-12-15,16,com,6385960,8062566,-1676606
2010-12-15,17,com,7536360,5261868,2274492
2010-12-15,18,com,9417214,7459536,1957678
2010-12-15,19,com,6650268,1619606,5030662
2010-12-15,20,com,3260869,2664938,595931
2010-12-15,21,com,4051313,8735510,-4684197
2010-12-15,22,com,3404151,6481323,-3077172
2010-12-15,23,com,3863438,220973,3642465
2010-12-15,0,vou,8734321,2680124,6054197
2010-12-15,1,vou,2304090,3490861,-1186771
2010-12-15,2,vou,6825219,8533046,-1707827
2010-12-15,3,vou,9190870,9563386,-372516
2010-12-15,4,vou,1936385,4587478,-2651093
2010-12-15,5,vou,7843557,6239282,1604275
2010-12-15,6,vou,9421462,7237307,2184155
2010-12-15,7,vou,7178784,5606327,1572457
2010-12-15,8,vou,8877897,8948187,-70290
2010-12-15,9,vou,6360169,3185714,3174455
2010-12-15,10,vou,6800760,3075035,3725725
2010-12-15,11,vou,8097928,9854297,-1756369
2010-12-15,12,vou,5479382,7109859,-1630477
2010-12-15,13,vou,629629,6488835,-5859206
2010-12-15,14,vou,6327112,171083,6156029
2010-12-15,15,vou,8971358,1041616,7929742
2010-12-15,16,vou,150995,9301932,-9150937
2010-12-15,17,vou,747378,8829001,-8081623
2010-12-15,18,vou,7557237,9754791,-2197554
2010-12-15,19,vou,8212863,1057998,7154865
2010-12-15,20,vou,2077819,1990407,87412
2010-12-15,21,vou,8138460,7138394,1000066
2010-12-15,22,vou,4265858,5344331,-1078473
2010-12-15,23,vou,9234564,4704244,4530320
2010-12-15,0,cm,4585707,1182443,3403264
2010-12-15,1,cm,1668485,7236536,-5568051
2010-12-15,2,cm,2366953,3771126,-1404173
2010-12-15,3,cm,9875275,1225433,8649842
2010-12-15,4,cm,2068340,7048050,-4979710
2010-12-15,5,cm,4965452,4007816,957636
2010-12-15,6,cm,6224955,3700501,2524454
2010-12-15,7,cm,5179902,1621625,3558277
2010-12-15,8,cm,9988810,6868648,3120162
2010-12-15,9,cm,8416401,3701321,4715080
2010-12-15,10,cm,9600194,3152960,6447234
2010-12-15,11,cm,7538260,4123723,3414537
2010-12-15,12,cm,8315262,6534442,1780820
2010-12-15,13,cm,2336499,7713080,-5376581
2010-12-15,14,cm,6435407,8103676,-1668269
2010-12-15,15,cm,6424330,3097966,3326364
2010-12-15,16,cm,6475402,7211555,-736153
2010-12-15,17,cm,5222522,5034439,188083
2010-12-15,18,cm,6013072,477948,5535124
2010-12-15,19,cm,1937907,4382609,-2444702
2010-12-15,20,cm,6728873,2036409,4692464
2010-12-15,21,cm,629978,9272162,-8642184
2010-12-15,22,cm,3071522,4511725,-1440203
2010-12-15,23,cm,2458459,1032186,1426273
2010-12-15,0,adj,2524493,5590321,-3065828
2010-12-15,1,adj,6039909,6714451,-674542
2010-12-15,2,adj,7754122,2281155,5472967
2010-12-15,3,adj,6352508,8346113,-1993605
2010-12-15,4,adj,5059932,7454125,-2394193
2010-12-15,5,adj,9686170,4125765,5560405
2010-12-15,6,adj,9892946,3973284,5919662
2010-12-15,7,adj,3618859,3087834,531025
2010-12-15,8,adj,7764210,8014732,-250522
2010-12-15,9,adj,7948884,4484465,3464419
2010-12-15,10,adj,7713743,5111358,2602385
2010-12-15,11,adj,8184997,7956247,228750
2010-12-15,12,adj,5730636,1469102,4261534
2010-12-15,13,adj,823547,3077029,-2253482
2010-12-15,14,adj,1650155,2981509,-1331354
2010-12-15,15,adj,8262934,729302,7533632
2010-12-15,16,adj,7740474,1784943,5955531
2010-12-15,17,adj,6537639,5171804,1365835
2010-12-15,18,adj,344093,6005654,-5661561
2010-12-15,19,adj,8669190,4725625,3943565
2010-12-15,20,adj,5745115,489020,5256095
2010-12-15,21,adj,7452178,1168113,6284065
2010-12-15,22,adj,8217426,9504403,-1286977
2010-12-15,23,adj,1722415,2867515,-1145100
2010-12-15,0,first,7925876,3796536,4129340
2010-12-15,1,first,1343040,4861939,-3518899
2010-12-15,2,first,2009633,3232017,-1222384
2010-12-15,3,first,9338610,9327961,10649
2010-12-15,4,first,8173854,3597856,4575998
2010-12-15,5,first,6159268,5862237,297031
2010-12-15,6,first,6728544,9916725,-3188181
2010-12-15,7,first,7660097,6832310,827787
2010-12-15,8,first,5348561,5479296,-130735
2010-12-15,9,first,1067012,875834,191178
2010-12-15,10,first,7117663,6787832,329831
2010-12-15,11,first,2153991,5607054,-3453063
2010-12-15,12,first,3579124,723866,2855258
2010-12-15,13,first,3896712,6730788,-2834076
2010-12-15,14,first,1189869,3145029,-1955160
2010-12-15,15,first,3716027,5577323,-1861296
2010-12-15,16,first,9467325,4163230,5304095
2010-12-15,17,first,5890595,8703562,-2812967
2010-12-15,18,first,6355834,3607990,2747844
2010-12-15,19,first,2229811,4809231,-2579420
2010-12-15,20,first,8152904,3982555,4170349
2010-12-15,21,first,8790571,7281246,1509325
2010-12-15,22,first,3044016,5993004,-2948988
2010-12-15,23,first,4462973,5977068,-1514095
2010-12-15,0,mon,3551699,2911415,640284
2010-12-15,1,mon,4850713,3834562,1016151
2010-12-15,2,mon,5992463,3699046,2293417
2010-12-15,3,mon,3601040,8372070,-4771030
2010-12-15,4,mon,6419655,1270604,5149051
2010-12-15,5,mon,9775161,7728227,2046934
2010-12-15,6,mon,8524029,1315847,7208182
2010-12-15,7,mon,8463949,8510241,-46292
2010-12-15,8,mon,10890,4513916,-4503026
2010-12-15,9,mon,8638002,8155751,482251
2010-12-15,10,mon,8670342,7214597,1455745
2010-12-15,11,mon,7853216,6114393,1738823
2010-12-15,12,mon,3825300,1959020,1866280
2010-12-15,13,mon,3177027,6673267,-3496240
2010-12-15,14,mon,5209188,811973,4397215
2010-12-15,15,mon,9880332,3713511,6166821
2010-12-15,16,mon,8472187,7961748,510439
2010-12-15,17,mon,5400458,4062026,1338432
2010-12-15,18,mon,2046479,8477561,-6431082
2010-12-15,19,mon,3545367,2821737,723630
2010-12-15,20,mon,6094263,9835662,-3741399
2010-12-15,21,mon,4191663,7325682,-3134019
2010-12-15,22,mon,9006594,2445235,6561359
2010-12-15,23,mon,4076852,2584445,1492407
2010-12-15,0,data,4703238,9292732,-4589494
2010-12-15,1,data,7456114,3461519,3994595
2010-12-15,2,data,2851689,4794082,-1942393
2010-12-15,3,data,3218105,231282,2986823
2010-12-15,4,data,4774630,6714232,-1939602
2010-12-15,5,data,4332290,1551874,2780416
2010-12-15,6,data,9718411,1928061,7790350
2010-12-15,7,data,4617620,7318323,-2700703
2010-12-15,8,data,3804376,4095676,-291300
2010-12-15,9,data,5754961,9400299,-3645338
2010-12-15,10,data,2697650,6052924,-3355274
2010-12-15,11,data,2092492,2698236,-605744
2010-12-15,12,data,6780503,3331604,3448899
2010-12-15,13,data,918879,9732793,-8813914
2010-12-15,14,data,129030,8604994,-8475964
2010-12-15,15,data,9794243,1339260,8454983
2010-12-15,16,data,6004656,9265038,-3260382
2010-12-15,17,data,1137212,9265319,-8128107
2010-12-15,18,data,2537333,6193490,-3656157
2010-12-15,19,data,2989745,53507,2936238
2010-12-15,20,data,7522925,9339198,-1816273
2010-12-15,21,data,8651153,398694,8252459
2010-12-15,22,data,8407868,3773106,4634762
2010-12-15,23,data,3019909,9760292,-6740383
2010-12-15,0,voice,6957835,3759862,3197973
2010-12-15,1,voice,9560561,8712741,847820
2010-12-15,2,voice,5952780,5587504,365276
2010-12-15,3,voice,9473454,8017220,1456234
2010-12-15,4,voice,1574169,7367817,-5793648
2010-12-15,5,voice,518340,3075617,-2557277
2010-12-15,6,voice,5683812,333347,5350465
2010-12-15,7,voice,6445060,2993581,3451479
2010-12-15,8,voice,704444,4425823,-3721379
2010-12-15,9,voice,4721982,2358702,2363280
2010-12-15,10,voice,8326965,6181203,2145762
2010-12-15,11,voice,3672443,567567,3104876
2010-12-15,12,voice,4304475,2156577,2147898
2010-12-15,13,voice,8191265,1085153,7106112
2010-12-15,14,voice,1145585,46814,1098771
2010-12-15,15,voice,8571224,8923734,-352510
2010-12-15,16,voice,7217749,6467762,749987
2010-12-15,17,voice,2394316,9416487,-7022171
2010-12-15,18,voice,1416870,9737516,-8320646
2010-12-15,19,voice,9938461,5306717,4631744
2010-12-15,20,voice,8591480,5012056,3579424
2010-12-15,21,voice,9426209,8742483,683726
2010-12-15,22,voice,7870199,6115507,1754692
2010-12-15,23,voice,7992454,2935065,5057389
2010-12-15,0,sms,5552112,3745789,1806323
2010-12-15,1,sms,3163105,3272641,-109536
2010-12-15,2,sms,8954880,6329687,2625193
2010-12-15,3,sms,1708372,9723238,-8014866
2010-12-15,4,sms,1299933,2262186,-962253
2010-12-15,5,sms,4361580,4095190,266390
2010-12-15,6,sms,5981919,9794517,-3812598
2010-12-15,7,sms,6763335,286953,6476382
2010-12-15,8,sms,4202825,9844320,-5641495
2010-12-15,9,sms,581906,7377991,-6796085
2010-12-15,10,sms,7356289,393894,6962395
2010-12-15,11,sms,2359247,1977074,382173
2010-12-15,12,sms,6081129,9295322,-3214193
2010-12-15,13,sms,6360855,6254962,105893
2010-12-15,14,sms,9884080,1575046,8309034
2010-12-15,15,sms,689089,532078,157011
2010-12-15,16,sms,7226845,9366373,-2139528
2010-12-15,17,sms,7706453,2925957,4780496
2010-12-15,18,sms,420188,950095,-529907
2010-12-15,19,sms,3636425,3129455,506970
2010-12-15,20,sms,2020144,1606513,413631
2010-12-15,21,sms,41555,8397223,-8355668
2010-12-15,22,sms,8751695,6640666,2111029
2010-12-15,23,sms,5169396,6430843,-1261447
2010-12-15,0,clr,8052855,9947084,-1894229
2010-12-15,1,clr,2625727,5898784,-3273057
2010-12-15,2,clr,3924129,7253852,-3329723
2010-12-15,3,clr,4996474,9399976,-4403502
2010-12-15,4,clr,2889676,6327085,-3437409
2010-12-15,5,clr,5568205,7792908,-2224703
2010-12-15,6,clr,5464339,9528044,-4063705
2010-12-15,7,clr,4025949,4268620,-242671
2010-12-15,8,clr,6445560,9875700,-3430140
2010-12-15,9,clr,4390756,6151573,-1760817
2010-12-15,10,clr,3660543,2609820,1050723
2010-12-15,11,clr,6028539,4216038,1812501
2010-12-15,12,clr,6800123,5123172,1676951
2010-12-15,13,clr,3940876,2099283,1841593
2010-12-15,14,clr,6373596,6265266,108330
2010-12-15,15,clr,1678671,9448662,-7769991
2010-12-15,16,clr,474073,2626546,-2152473
2010-12-15,17,clr,6038828,1520535,4518293
2010-12-15,18,clr,6412308,4332805,2079503
2010-12-15,19,clr,9189128,6010687,3178441
2010-12-15,20,clr,4067862,1254870,2812992
2010-12-15,21,clr,3786513,1208004,2578509
2010-12-15,22,clr,5321367,5085555,235812
2010-12-15,23,clr,944962,7203931,-6258969
2010-12-16,0,com,8772090,7166383,1605707
2010-12-16,1,com,1257882,6454519,-5196637
2010-12-16,2,com,5065475,8345437,-3279962
2010-12-16,3,com,5843478,302619,5540859
2010-12-16,4,com,3428213,2596214,831999
2010-12-16,5,com,1991194,4541374,-2550180
2010-12-16,6,com,9919127,8058575,1860552
2010-12-16,7,com,6735440,9510226,-2774786
2010-12-16,8,com,1247003,9967489,-8720486
2010-12-16,9,com,7937276,7698649,238627
2010-12-16,10,com,9532055,5394585,4137470
2010-12-16,11,com,283268,1464030,-1180762
2010-12-16,12,com,8257077,2336040,5921037
2010-12-16,13,com,3946603,8972582,-5025979
2010-12-16,14,com,6510722,1349004,5161718
2010-12-16,15,com,527337,8436612,-7909275
2010-12-16,16,com,336968,7341886,-7004918
2010-12-16,17,com,8769222,2950876,5818346
2010-12-16,18,com,2040624,2181621,-140997
2010-12-16,19,com,2166436,64809,2101627
2010-12-16,20,com,8749569,3871883,4877686
2010-12-16,21,com,6860941,4286801,2574140
2010-12-16,22,com,3360965,1312303,2048662
2010-12-16,23,com,7599434,6898081,701353
2010-12-16,0,vou,8512906,1104910,7407996
2010-12-16,1,vou,3427567,989746,2437821
2010-12-16,2,vou,7618555,8028543,-409988
2010-12-16,3,vou,1120730,8963043,-7842313
2010-12-16,4,vou,7343071,5145367,2197704
2010-12-16,5,vou,4160790,6792713,-2631923
2010-12-16,6,vou,1305384,5214543,-3909159
2010-12-16,7,vou,8548555,6399605,2148950
2010-12-16,8,vou,6433383,2422961,4010422
2010-12-16,9,vou,7937851,9543136,-1605285
2010-12-16,10,vou,7263832,9968739,-2704907
2010-12-16,11,vou,6214063,1780881,4433182
2010-12-16,12,vou,6148844,6288025,-139181
2010-12-16,13,vou,7731894,1554474,6177420
2010-12-16,14,vou,7976145,1291184,6684961
2010-12-16,15,vou,9133839,3550251,5583588
2010-12-16,16,vou,4858731,986250,3872481
2010-12-16,17,vou,8755585,4531964,4223621
2010-12-16,18,vou,4424423,7886088,-3461665
2010-12-16,19,vou,7229380,7131766,97614
2010-12-16,20,vou,3396893,5259768,-1862875
2010-12-16,21,vou,2606704,1105953,1500751
2010-12-16,22,vou,952798,3239024,-2286226
2010-12-16,23,vou,6068716,3893006,2175710
2010-12-16,0,cm,3929171,6990031,-3060860
2010-12-16,1,cm,3107534,3806329,-698795
2010-12-16,2,cm,247551,8460788,-8213237
2010-12-16,3,cm,367932,4126755,-3758823
2010-12-16,4,cm,1287649,6478007,-5190358
2010-12-16,5,cm,312554,9729518,-9416964
2010-12-16,6,cm,5154538,3049254,2105284
2010-12-16,7,cm,375033,3789134,-3414101
2010-12-16,8,cm,1187029,1164556,22473
2010-12-16,9,cm,911836,3308144,-2396308
2010-12-16,10,cm,5450076,1593650,3856426
2010-12-16,11,cm,695847,3379513,-2683666
2010-12-16,12,cm,3890922,534234,3356688
2010-12-16,13,cm,2218082,7106164,-4888082
2010-12-16,14,cm,9726804,174724,9552080
2010-12-16,15,cm,6906296,8045682,-1139386
2010-12-16,16,cm,7927534,1831887,6095647
2010-12-16,17,cm,209581,3996081,-3786500
2010-12-16,18,cm,7689158,9795670,-2106512
2010-12-16,19,cm,3755942,4141413,-385471
2010-12-16,20,cm,1470240,526592,943648
2010-12-16,21,cm,1895232,5910742,-4015510
2010-12-16,22,cm,8137574,9684214,-1546640
2010-12-16,23,cm,1933600,6061083,-4127483
2010-12-16,0,adj,6892132,7924930,-1032798
2010-12-16,1,adj,1194452,6227014,-5032562
2010-12-16,2,adj,5726586,8893382,-3166796
2010-12-16,3,adj,3286695,4026226,-739531
2010-12-16,4,adj,586055,2906441,-2320386
2010-12-16,5,adj,5040458,773054,4267404
2010-12-16,6,adj,6779015,7773848,-994833
2010-12-16,7,adj,413097,9430709,-9017612
2010-12-16,8,adj,9698181,4823763,4874418
2010-12-16,9,adj,3238361,9761727,-6523366
2010-12-16,10,adj,4361924,1265420,3096504
2010-12-16,11,adj,1288857,9457010,-8168153
2010-12-16,12,adj,8502060,3895189,4606871
2010-12-16,13,adj,1751280,4777644,-3026364
2010-12-16,14,adj,2251477,4492572,-2241095
2010-12-16,15,adj,7437711,1739483,5698228
2010-12-16,16,adj,9131054,4462642,4668412
2010-12-16,17,adj,8551501,1397832,7153669
2010-12-16,18,adj,8079483,4355760,3723723
2010-12-16,19,adj,8543044,3688288,4854756
2010-12-16,20,adj,8912553,4543610,4368943
2010-12-16,21,adj,9171456,4946800,4224656
2010-12-16,22,adj,1468514,4190007,-2721493
2010-12-16,23,adj,4730681,9622508,-4891827
2010-12-16,0,first,7630594,8839728,-1209134
2010-12-16,1,first,4611688,6942502,-2330814
2010-12-16,2,first,8313325,6089272,2224053
2010-12-16,3,first,4349632,5217423,-867791
2010-12-16,4,first,8355798,5298318,3057480
2010-12-16,5,first,1568842,7080865,-5512023
2010-12-16,6,first,3725916,4199451,-473535
2010-12-16,7,first,8515584,7583437,932147
2010-12-16,8,first,3366600,1937798,1428802
2010-12-16,9,first,2291074,830856,1460218
2010-12-16,10,first,705327,49895,655432
2010-12-16,11,first,7983823,5439403,2544420
2010-12-16,12,first,8833759,1746425,7087334
2010-12-16,13,first,5271882,6049695,-777813
2010-12-16,14,first,2922323,1779833,1142490
2010-12-16,15,first,4676541,3564352,1112189
2010-12-16,16,first,5639054,824963,4814091
2010-12-16,17,first,3788198,6880376,-3092178
2010-12-16,18,first,5772623,4014928,1757695
2010-12-16,19,first,1511025,5297578,-3786553
2010-12-16,20,first,897366,7964089,-7066723
2010-12-16,21,first,1355007,231924,1123083
2010-12-16,22,first,3816708,5889834,-2073126
2010-12-16,23,first,8988162,3331921,5656241
2010-12-16,0,mon,1011656,8330276,-7318620
2010-12-16,1,mon,9476842,1178483,8298359
2010-12-16,2,mon,4401095,3150661,1250434
2010-12-16,3,mon,4777929,6814073,-2036144
2010-12-16,4,mon,6599397,3948281,2651116
2010-12-16,5,mon,2732684,8506182,-5773498
2010-12-16,6,mon,8110508,5123558,2986950
2010-12-16,7,mon,7236199,8986453,-1750254
2010-12-16,8,mon,8493298,2635135,5858163
2010-12-16,9,mon,7279336,8254837,-975501
2010-12-16,10,mon,1621718,5732282,-4110564
2010-12-16,11,mon,9124312,6684707,2439605
2010-12-16,12,mon,3073994,3515078,-441084
2010-12-16,13,mon,6532150,2248193,4283957
2010-12-16,14,mon,3858738,3340358,518380
2010-12-16,15,mon,9266151,1283808,7982343
2010-12-16,16,mon,4760694,1072996,3687698
2010-12-16,17,mon,7573237,4207663,3365574
2010-12-16,18,mon,438571,8368401,-7929830
2010-12-16,19,mon,1133214,8389557,-7256343
2010-12-16,20,mon,243991,8409699,-8165708
2010-12-16,21,mon,3004163,9770127,-6765964
2010-12-16,22,mon,986922,2345724,-1358802
2010-12-16,23,mon,5099437,379765,4719672
2010-12-16,0,data,4157494,8129794,-3972300
2010-12-16,1,data,8111275,7585520,525755
2010-12-16,2,data,3730407,3226254,504153
2010-12-16,3,data,3783443,8214691,-4431248
2010-12-16,4,data,2708782,2978654,-269872
2010-12-16,5,data,4460096,3284732,1175364
2010-12-16,6,data,831239,7095818,-6264579
2010-12-16,7,data,9839266,5935712,3903554
2010-12-16,8,data,4565795,5204316,-638521
2010-12-16,9,data,9659524,8402514,1257010
2010-12-16,10,data,5509803,8435926,-2926123
2010-12-16,11,data,8290686,5919833,2370853
2010-12-16,12,data,3925914,3513686,412228
2010-12-16,13,data,8730597,4190934,4539663
2010-12-16,14,data,7286971,8045384,-758413
2010-12-16,15,data,8484401,3489825,4994576
2010-12-16,16,data,4497244,9529802,-5032558
2010-12-16,17,data,3348442,1158503,2189939
2010-12-16,18,data,6132393,4699859,1432534
2010-12-16,19,data,3002679,1664079,1338600
2010-12-16,20,data,9146777,7027059,2119718
2010-12-16,21,data,7269376,9214521,-1945145
2010-12-16,22,data,1992404,8557691,-6565287
2010-12-16,23,data,7303608,6993936,309672
2010-12-16,0,voice,7123065,1040643,6082422
2010-12-16,1,voice,5318895,8238584,-2919689
2010-12-16,2,voice,7550207,1440023,6110184
2010-12-16,3,voice,6048709,9962227,-3913518
2010-12-16,4,voice,542591,9779626,-9237035
2010-12-16,5,voice,5899040,1748133,4150907
2010-12-16,6,voice,1129968,5936982,-4807014
2010-12-16,7,voice,1351607,9870592,-8518985
2010-12-16,8,voice,6236894,3672316,2564578
2010-12-16,9,voice,2844951,9877000,-7032049
2010-12-16,10,voice,9206126,525257,8680869
2010-12-16,11,voice,8150948,8045631,105317
2010-12-16,12,voice,4846989,9730672,-4883683
2010-12-16,13,voice,7607714,749124,6858590
2010-12-16,14,voice,9385044,6142990,3242054
2010-12-16,15,voice,8160695,6268808,1891887
2010-12-16,16,voice,9334210,8761348,572862
2010-12-16,17,voice,8457722,401982,8055740
2010-12-16,18,voice,7906363,7303143,603220
2010-12-16,19,voice,1992282,3414992,-1422710
2010-12-16,20,voice,1654832,1841375,-186543
2010-12-16,21,voice,6679904,4023120,2656784
2010-12-16,22,voice,3155634,329978,2825656
2010-12-16,23,voice,9170827,382732,8788095
2010-12-16,0,sms,7957986,8093281,-135295
2010-12-16,1,sms,8069177,8020837,48340
2010-12-16,2,sms,374766,7682920,-7308154
2010-12-16,3,sms,1360169,9296324,-7936155
2010-12-16,4,sms,1171736,8346136,-7174400
2010-12-16,5,sms,7580985,3756848,3824137
2010-12-16,6,sms,6017679,3566237,2451442
2010-12-16,7,sms,7167968,4990568,2177400
2010-12-16,8,sms,2927051,2374853,552198
2010-12-16,9,sms,3459524,7829438,-4369914
2010-12-16,10,sms,863945,8068110,-7204165
2010-12-16,11,sms,4383697,7812018,-3428321
2010-12-16,12,sms,5937362,882150,5055212
2010-12-16,13,sms,1431677,1013856,417821
2010-12-16,14,sms,5739706,5451845,287861
2010-12-16,15,sms,2573259,9730723,-7157464
2010-12-16,16,sms,9576429,9969935,-393506
2010-12-16,17,sms,8903234,9559886,-656652
2010-12-16,18,sms,5819526,5298321,521205
2010-12-16,19,sms,7123133,3817619,3305514
2010-12-16,20,sms,1022308,4522420,-3500112
2010-12-16,21,sms,1080910,2837626,-1756716
2010-12-16,22,sms,2674154,3940072,-1265918
2010-12-16,23,sms,8007302,8391890,-384588
2010-12-16,0,clr,2579493,6684086,-4104593
2010-12-16,1,clr,2033098,5695500,-3662402
2010-12-16,2,clr,9254054,6328212,2925842
2010-12-16,3,clr,2821408,2457690,363718
2010-12-16,4,clr,2808654,3983817,-1175163
2010-12-16,5,clr,3372021,4189415,-817394
2010-12-16,6,clr,9908729,5408478,4500251
2010-12-16,7,clr,4677310,3585306,1092004
2010-12-16,8,clr,5469125,2218862,3250263
2010-12-16,9,clr,9889374,3251174,6638200
2010-12-16,10,clr,3368725,5239173,-1870448
2010-12-16,11,clr,9660470,1007889,8652581
2010-12-16,12,clr,7316537,6775587,540950
2010-12-16,13,clr,8501384,9264068,-762684
2010-12-16,14,clr,3777454,314556,3462898
2010-12-16,15,clr,4392214,8613152,-4220938
2010-12-16,16,clr,8053042,5016725,3036317
2010-12-16,17,clr,2239542,121217,2118325
2010-12-16,18,clr,6431974,6215348,216626
2010-12-16,19,clr,8699644,8454673,244971
2010-12-16,20,clr,4890589,1089264,3801325
2010-12-16,21,clr,4626313,7264212,-2637899
2010-12-16,22,clr,3512784,4925666,-1412882
2010-12-16,23,clr,7854185,6458225,1395960
2010-12-17,0,com,9819915,7145314,2674601
2010-12-17,1,com,387188,7664382,-7277194
2010-12-17,2,com,5478891,4605801,873090
2010-12-17,3,com,8964999,3337392,5627607
2010-12-17,4,com,6858616,384148,6474468
2010-12-17,5,com,9324623,6447373,2877250
2010-12-17,6,com,3533683,3081655,452028
2010-12-17,7,com,6153767,373317,5780450
2010-12-17,8,com,7015122,5640045,1375077
2010-12-17,9,com,2669468,8844851,-6175383
2010-12-17,10,com,1993481,910301,1083180
2010-12-17,11,com,4717161,2570715,2146446
2010-12-17,12,com,9954432,1008598,8945834
2010-12-17,13,com,305919,7913215,-7607296
2010-12-17,14,com,1350062,1854931,-504869
2010-12-17,15,com,7490529,1973127,5517402
2010-12-17,16,com,4263289,7569464,-3306175
2010-12-17,17,com,7553270,6782179,771091
2010-12-17,18,com,75507,8973850,-8898343
2010-12-17,19,com,7409699,8333323,-923624
2010-12-17,20,com,1743646,2890756,-1147110
2010-12-17,21,com,6637580,4558990,2078590
2010-12-17,22,com,9349738,8853470,496268
2010-12-17,23,com,1752472,4115869,-2363397
2010-12-17,0,vou,343425,9726434,-9383009
2010-12-17,1,vou,3209272,4501985,-1292713
2010-12-17,2,vou,8517803,552436,7965367
2010-12-17,3,vou,8425838,7015894,1409944
2010-12-17,4,vou,2181192,9578536,-7397344
2010-12-17,5,vou,6383040,502741,5880299
2010-12-17,6,vou,9835676,7902484,1933192
2010-12-17,7,vou,6606325,6516193,90132
2010-12-17,8,vou,5144105,92142,5051963
2010-12-17,9,vou,3388852,1482982,1905870
2010-12-17,10,vou,4384814,9361542,-4976728
2010-12-17,11,vou,8071624,9921240,-1849616
2010-12-17,12,vou,5057240,9206225,-4148985
2010-12-17,13,vou,245575,9254559,-9008984
2010-12-17,14,vou,7896013,3667254,4228759
2010-12-17,15,vou,2818125,9719845,-6901720
2010-12-17,16,vou,3803045,8462043,-4658998
2010-12-17,17,vou,6912120,6126746,785374
2010-12-17,18,vou,316290,6600715,-6284425
2010-12-17,19,vou,8894294,9392469,-498175
2010-12-17,20,vou,4789494,3905361,884133
2010-12-17,21,vou,7688660,2865454,4823206
2010-12-17,22,vou,4432093,6207579,-1775486
2010-12-17,23,vou,3065152,1132580,1932572
2010-12-17,0,cm,6182258,2448045,3734213
2010-12-17,1,cm,4644087,5305212,-661125
2010-12-17,2,cm,8911329,5284294,3627035
2010-12-17,3,cm,7145228,7729909,-584681
2010-12-17,4,cm,633098,9451171,-8818073
2010-12-17,5,cm,1705824,8378356,-6672532
2010-12-17,6,cm,6765287,167393,6597894
2010-12-17,7,cm,9648581,7263003,2385578
2010-12-17,8,cm,6616717,2833468,3783249
2010-12-17,9,cm,6694406,3277800,3416606
2010-12-17,10,cm,8652897,8076150,576747
2010-12-17,11,cm,3816597,527826,3288771
2010-12-17,12,cm,3163769,7224608,-4060839
2010-12-17,13,cm,6405631,9070867,-2665236
2010-12-17,14,cm,7449993,1554930,5895063
2010-12-17,15,cm,2683669,1360423,1323246
2010-12-17,16,cm,5701051,9711362,-4010311
2010-12-17,17,cm,6398768,2873747,3525021
2010-12-17,18,cm,7839970,6846441,993529
2010-12-17,19,cm,217404,3266387,-3048983
2010-12-17,20,cm,2189006,8916057,-6727051
2010-12-17,21,cm,1244341,799561,444780
2010-12-17,22,cm,7064179,9731431,-2667252
2010-12-17,23,cm,7744558,2422194,5322364
2010-12-17,0,adj,8350593,9207917,-857324
2010-12-17,1,adj,2478881,1986559,492322
2010-12-17,2,adj,7164842,5156724,2008118
2010-12-17,3,adj,9167562,6407396,2760166
2010-12-17,4,adj,5658470,1762689,3895781
2010-12-17,5,adj,3522276,3097235,425041
2010-12-17,6,adj,5135780,3705144,1430636
2010-12-17,7,adj,6516726,2292905,4223821
2010-12-17,8,adj,7049567,4991231,2058336
2010-12-17,9,adj,3216983,3548808,-331825
2010-12-17,10,adj,3039271,2669126,370145
2010-12-17,11,adj,7236815,9983487,-2746672
2010-12-17,12,adj,2172496,988181,1184315
2010-12-17,13,adj,8446866,579906,7866960
2010-12-17,14,adj,7549797,8827063,-1277266
2010-12-17,15,adj,3113828,4626158,-1512330
2010-12-17,16,adj,3197438,4720115,-1522677
2010-12-17,17,adj,4908840,8009328,-3100488
2010-12-17,18,adj,2933516,7417477,-4483961
2010-12-17,19,adj,6733476,9586403,-2852927
2010-12-17,20,adj,956814,3517912,-2561098
2010-12-17,21,adj,3082450,2980275,102175
2010-12-17,22,adj,6297157,8679639,-2382482
2010-12-17,23,adj,709338,996254,-286916
2010-12-17,0,first,153739,5737002,-5583263
2010-12-17,1,first,3792443,7106428,-3313985
2010-12-17,2,first,8550513,9281689,-731176
2010-12-17,3,first,4865689,9873243,-5007554
2010-12-17,4,first,2720045,3986790,-1266745
2010-12-17,5,first,8860811,6751279,2109532
2010-12-17,6,first,6480138,2340450,4139688
2010-12-17,7,first,1929911,1314727,615184
2010-12-17,8,first,6949625,9185209,-2235584
2010-12-17,9,first,9450093,5463964,3986129
2010-12-17,10,first,9130922,6102871,3028051
2010-12-17,11,first,5315074,938226,4376848
2010-12-17,12,first,4322353,632666,3689687
2010-12-17,13,first,1596381,8359192,-6762811
2010-12-17,14,first,7170253,3228402,3941851
2010-12-17,15,first,4711642,4681647,29995
2010-12-17,16,first,9047492,1314056,7733436
2010-12-17,17,first,4732072,2457230,2274842
2010-12-17,18,first,781996,9520197,-8738201
2010-12-17,19,first,4179582,656659,3522923
2010-12-17,20,first,574559,7546362,-6971803
2010-12-17,21,first,4229765,1802419,2427346
2010-12-17,22,first,4534556,7068839,-2534283
2010-12-17,23,first,7451847,7718115,-266268
2010-12-17,0,mon,2231341,7299652,-5068311
2010-12-17,1,mon,1583127,3438787,-1855660
2010-12-17,2,mon,4124579,5696742,-1572163
2010-12-17,3,mon,9726990,4169025,5557965
2010-12-17,4,mon,9383908,2437784,6946124
2010-12-17,5,mon,1160107,5503451,-4343344
2010-12-17,6,mon,3225830,4927253,-1701423
2010-12-17,7,mon,2799001,7552094,-4753093
2010-12-17,8,mon,4521178,7925592,-3404414
2010-12-17,9,mon,4456222,7816932,-3360710
2010-12-17,10,mon,3477465,426100,3051365
2010-12-17,11,mon,789191,1879458,-1090267
2010-12-17,12,mon,7187974,8017629,-829655
2010-12-17,13,mon,2142111,8656559,-6514448
2010-12-17,14,mon,4499365,2810174,1689191
2010-12-17,15,mon,9294425,9620436,-326011
2010-12-17,16,mon,9627916,6362868,3265048
2010-12-17,17,mon,4286559,5095144,-808585
2010-12-17,18,mon,1487458,7915455,-6427997
2010-12-17,19,mon,5647974,1027679,4620295
2010-12-17,20,mon,7030855,2641394,4389461
2010-12-17,21,mon,75041,3396892,-3321851
2010-12-17,22,mon,8981255,1087615,7893640
2010-12-17,23,mon,5833480,7468124,-1634644
2010-12-17,0,data,5701950,2212396,3489554
2010-12-17,1,data,9827113,8951737,875376
2010-12-17,2,data,2522003,2869709,-347706
2010-12-17,3,data,5840278,2216276,3624002
2010-12-17,4,data,2479373,6612877,-4133504
2010-12-17,5,data,6115950,1225620,4890330
2010-12-17,6,data,2394567,1893790,500777
2010-12-17,7,data,7714209,1904574,5809635
2010-12-17,8,data,5957388,9150681,-3193293
2010-12-17,9,data,2835901,2968491,-132590
2010-12-17,10,data,6451744,9555345,-3103601
2010-12-17,11,data,3724839,2479481,1245358
2010-12-17,12,data,7932536,2771638,5160898
2010-12-17,13,data,3972070,6143535,-2171465
2010-12-17,14,data,9391084,9380210,10874
2010-12-17,15,data,4024687,6563561,-2538874
2010-12-17,16,data,6590514,5725087,865427
2010-12-17,17,data,4570126,2084182,2485944
2010-12-17,18,data,9126748,2572040,6554708
2010-12-17,19,data,2629511,6994563,-4365052
2010-12-17,20,data,2983079,5670525,-2687446
2010-12-17,21,data,793877,6597757,-5803880
2010-12-17,22,data,9282812,7139944,2142868
2010-12-17,23,data,1055645,3769639,-2713994
2010-12-17,0,voice,6058947,2699690,3359257
2010-12-17,1,voice,1380317,1379552,765
2010-12-17,2,voice,7734120,4268845,3465275
2010-12-17,3,voice,690558,4093369,-3402811
2010-12-17,4,voice,7785288,1209119,6576169
2010-12-17,5,voice,7584388,851077,6733311
2010-12-17,6,voice,8144844,4336792,3808052
2010-12-17,7,voice,1054193,168901,885292
2010-12-17,8,voice,5616519,1855971,3760548
2010-12-17,9,voice,3225938,8718369,-5492431
2010-12-17,10,voice,9331830,31071,9300759
2010-12-17,11,voice,4510433,6277532,-1767099
2010-12-17,12,voice,7805085,1079545,6725540
2010-12-17,13,voice,5940847,44336,5896511
2010-12-17,14,voice,5919498,163800,5755698
2010-12-17,15,voice,8586202,2428669,6157533
2010-12-17,16,voice,89107,8746294,-8657187
2010-12-17,17,voice,7265053,4832200,2432853
2010-12-17,18,voice,8099853,591429,7508424
2010-12-17,19,voice,3178180,3378010,-199830
2010-12-17,20,voice,5624227,2047357,3576870
2010-12-17,21,voice,9435281,3288871,6146410
2010-12-17,22,voice,4219090,5069261,-850171
2010-12-17,23,voice,2957809,6336801,-3378992
2010-12-17,0,sms,8601289,7583544,1017745
2010-12-17,1,sms,9774217,5669529,4104688
2010-12-17,2,sms,550976,6305066,-5754090
2010-12-17,3,sms,5647443,2355623,3291820
2010-12-17,4,sms,9314080,7339543,1974537
2010-12-17,5,sms,7431077,2372761,5058316
2010-12-17,6,sms,1872874,6860498,-4987624
2010-12-17,7,sms,8649367,7564186,1085181
2010-12-17,8,sms,1490829,5504834,-4014005
2010-12-17,9,sms,7199628,746200,6453428
2010-12-17,10,sms,7769703,9703730,-1934027
2010-12-17,11,sms,2217671,7147742,-4930071
2010-12-17,12,sms,4000109,9822776,-5822667
2010-12-17,13,sms,2699452,4859715,-2160263
2010-12-17,14,sms,8746231,4439812,4306419
2010-12-17,15,sms,9497069,4632218,4864851
2010-12-17,16,sms,7596364,1623337,5973027
2010-12-17,17,sms,9798209,9252035,546174
2010-12-17,18,sms,4789454,5812958,-1023504
2010-12-17,19,sms,4609957,4980451,-370494
2010-12-17,20,sms,5519994,9268180,-3748186
2010-12-17,21,sms,1575183,5054305,-3479122
2010-12-17,22,sms,816605,3693523,-2876918
2010-12-17,23,sms,2571264,7049630,-4478366
2010-12-17,0,clr,6067879,2676907,3390972
2010-12-17,1,clr,8233145,7952831,280314
2010-12-17,2,clr,1791765,4552,1787213
2010-12-17,3,clr,1452099,6988889,-5536790
2010-12-17,4,clr,2414518,1858398,556120
2010-12-17,5,clr,6994297,5863568,1130729
2010-12-17,6,clr,6208800,8082926,-1874126
2010-12-17,7,clr,9853193,9070922,782271
2010-12-17,8,clr,6990723,1231935,5758788
2010-12-17,9,clr,557537,44100,513437
2010-12-17,10,clr,5086931,6606886,-1519955
2010-12-17,11,clr,1404057,7161191,-5757134
2010-12-17,12,clr,9141628,81750,9059878
2010-12-17,13,clr,9143936,9320558,-176622
2010-12-17,14,clr,207971,1393551,-1185580
2010-12-17,15,clr,1400902,362000,1038902
2010-12-17,16,clr,8645517,7972423,673094
2010-12-17,17,clr,5529511,335100,5194411
2010-12-17,18,clr,1156745,2728545,-1571800
2010-12-17,19,clr,8666926,5418044,3248882
2010-12-17,20,clr,9521596,5160760,4360836
2010-12-17,21,clr,1733563,1642645,90918
2010-12-17,22,clr,6795260,7105481,-310221
2010-12-17,23,clr,8762143,9374176,-612033
2010-12-18,0,com,7115341,3004975,4110366
2010-12-18,1,com,2008254,5185321,-3177067
2010-12-18,2,com,6287171,3492039,2795132
2010-12-18,3,com,9762153,3806550,5955603
2010-12-18,4,com,4908513,9357574,-4449061
2010-12-18,5,com,510252,5837477,-5327225
2010-12-18,6,com,5545786,9712899,-4167113
2010-12-18,7,com,13872,7019249,-7005377
2010-12-18,8,com,1607811,3128154,-1520343
2010-12-18,9,com,3451183,7471215,-4020032
2010-12-18,10,com,8493178,3000715,5492463
2010-12-18,11,com,5841729,7075499,-1233770
2010-12-18,12,com,1146213,7758591,-6612378
2010-12-18,13,com,7064293,3919862,3144431
2010-12-18,14,com,6669559,9287831,-2618272
2010-12-18,15,com,6774470,9276711,-2502241
2010-12-18,16,com,1438699,9231666,-7792967
2010-12-18,17,com,4962042,8091840,-3129798
2010-12-18,18,com,7096650,2576381,4520269
2010-12-18,19,com,5631253,5462815,168438
2010-12-18,20,com,5681897,641704,5040193
2010-12-18,21,com,6554958,1329700,5225258
2010-12-18,22,com,4608128,4991638,-383510
2010-12-18,23,com,1936535,6525703,-4589168
2010-12-18,0,vou,5407773,578420,4829353
2010-12-18,1,vou,5323243,7881729,-2558486
2010-12-18,2,vou,1292958,5801073,-4508115
2010-12-18,3,vou,7315179,8753507,-1438328
2010-12-18,4,vou,8104163,5680442,2423721
2010-12-18,5,vou,9386334,9583878,-197544
2010-12-18,6,vou,4888608,8440904,-3552296
2010-12-18,7,vou,4155636,4449160,-293524
2010-12-18,8,vou,4464120,1951813,2512307
2010-12-18,9,vou,5395344,6457658,-1062314
2010-12-18,10,vou,6799024,80711,6718313
2010-12-18,11,vou,4995694,8705430,-3709736
2010-12-18,12,vou,4757962,1481457,3276505
2010-12-18,13,vou,1130826,3611949,-2481123
2010-12-18,14,vou,5902441,7004308,-1101867
2010-12-18,15,vou,2902815,2181128,721687
2010-12-18,16,vou,4329077,785901,3543176
2010-12-18,17,vou,8502348,7261433,1240915
2010-12-18,18,vou,8732655,9444594,-711939
2010-12-18,19,vou,8167376,2447089,5720287
2010-12-18,20,vou,8359648,5225654,3133994
2010-12-18,21,vou,1870435,7188801,-5318366
2010-12-18,22,vou,431288,7166778,-6735490
2010-12-18,23,vou,8178081,7602050,576031
2010-12-18,0,cm,8723379,7908482,814897
2010-12-18,1,cm,7111109,9266959,-2155850
2010-12-18,2,cm,4620819,490762,4130057
2010-12-18,3,cm,9086918,1745401,7341517
2010-12-18,4,cm,9103442,309468,8793974
2010-12-18,5,cm,5082416,4414636,667780
2010-12-18,6,cm,1891749,9215399,-7323650
2010-12-18,7,cm,8984190,252389,8731801
2010-12-18,8,cm,1787760,8763762,-6976002
2010-12-18,9,cm,9425488,8896321,529167
2010-12-18,10,cm,1891770,1588198,303572
2010-12-18,11,cm,5068085,5099667,-31582
2010-12-18,12,cm,463391,7018229,-6554838
2010-12-18,13,cm,241381,3942778,-3701397
2010-12-18,14,cm,4287513,6282292,-1994779
2010-12-18,15,cm,3532179,3704055,-171876
2010-12-18,16,cm,9411063,5646512,3764551
2010-12-18,17,cm,3730838,8858839,-5128001
2010-12-18,18,cm,1133916,3425776,-2291860
2010-12-18,19,cm,5822059,466439,5355620
2010-12-18,20,cm,6306840,8564131,-2257291
2010-12-18,21,cm,6709518,1155776,5553742
2010-12-18,22,cm,2632339,8765315,-6132976
2010-12-18,23,cm,3421848,9417752,-5995904
2010-12-18,0,adj,2956804,7138068,-4181264
2010-12-18,1,adj,6911778,9485151,-2573373
2010-12-18,2,adj,5205432,3138982,2066450
2010-12-18,3,adj,6016982,6317757,-300775
2010-12-18,4,adj,2183939,1665357,518582
2010-12-18,5,adj,8186954,1647021,6539933
2010-12-18,6,adj,8646644,3624237,5022407
2010-12-18,7,adj,6666842,9459799,-2792957
2010-12-18,8,adj,6795842,6037221,758621
2010-12-18,9,adj,7201356,8614886,-1413530
2010-12-18,10,adj,5241625,4603376,638249
2010-12-18,11,adj,8103939,6070286,2033653
2010-12-18,12,adj,1588223,212753,1375470
2010-12-18,13,adj,3523898,7842917,-4319019
2010-12-18,14,adj,1204703,1294322,-89619
2010-12-18,15,adj,1721389,2854467,-1133078
2010-12-18,16,adj,7949279,5042950,2906329
2010-12-18,17,adj,3363275,6798836,-3435561
2010-12-18,18,adj,5285304,3329813,1955491
2010-12-18,19,adj,2355910,1677073,678837
2010-12-18,20,adj,5472936,3631978,1840958
2010-12-18,21,adj,9923000,1802606,8120394
2010-12-18,22,adj,5093486,6506251,-1412765
2010-12-18,23,adj,6551351,579683,5971668
2010-12-18,0,first,464483,1216001,-751518
2010-12-18,1,first,8106913,3197991,4908922
2010-12-18,2,first,4160862,7329169,-3168307
2010-12-18,3,first,562222,8135262,-7573040
2010-12-18,4,first,9645218,7273271,2371947
2010-12-18,5,first,2560737,710117,1850620
2010-12-18,6,first,4112931,2413974,1698957
2010-12-18,7,first,3398110,1514287,1883823
2010-12-18,8,first,5340046,3015428,2324618
2010-12-18,9,first,8191769,1289503,6902266
2010-12-18,10,first,8962098,9151917,-189819
2010-12-18,11,first,4348594,4222332,126262
2010-12-18,12,first,5013335,9194086,-4180751
2010-12-18,13,first,236686,6189637,-5952951
2010-12-18,14,first,5112344,9849101,-4736757
2010-12-18,15,first,2070760,6539300,-4468540
2010-12-18,16,first,550165,7585148,-7034983
2010-12-18,17,first,1493560,3117184,-1623624
2010-12-18,18,first,7270256,3081431,4188825
2010-12-18,19,first,3684097,7640033,-3955936
2010-12-18,20,first,8100987,3485020,4615967
2010-12-18,21,first,9010215,7356017,1654198
2010-12-18,22,first,4964003,2218537,2745466
2010-12-18,23,first,4202667,8357336,-4154669
2010-12-18,0,mon,8589382,9774753,-1185371
2010-12-18,1,mon,2720760,198609,2522151
2010-12-18,2,mon,3531053,7525790,-3994737
2010-12-18,3,mon,2454523,8172209,-5717686
2010-12-18,4,mon,7419998,1119563,6300435
2010-12-18,5,mon,3834892,3351978,482914
2010-12-18,6,mon,4435595,1352339,3083256
2010-12-18,7,mon,8725317,9533182,-807865
2010-12-18,8,mon,75798,7603779,-7527981
2010-12-18,9,mon,4997755,677915,4319840
2010-12-18,10,mon,1395940,7285985,-5890045
2010-12-18,11,mon,7287757,2200493,5087264
2010-12-18,12,mon,907288,2148459,-1241171
2010-12-18,13,mon,3963281,8013156,-4049875
2010-12-18,14,mon,8312012,9803741,-1491729
2010-12-18,15,mon,7915437,5849100,2066337
2010-12-18,16,mon,478216,3485325,-3007109
2010-12-18,17,mon,7918113,4761005,3157108
2010-12-18,18,mon,3642281,6580224,-2937943
2010-12-18,19,mon,9909134,8840875,1068259
2010-12-18,20,mon,1969410,3256045,-1286635
2010-12-18,21,mon,5892281,2630189,3262092
2010-12-18,22,mon,2623048,1286317,1336731
2010-12-18,23,mon,4990207,972679,4017528
2010-12-18,0,data,3609343,7866783,-4257440
2010-12-18,1,data,9669644,3518594,6151050
2010-12-18,2,data,4800014,7757914,-2957900
2010-12-18,3,data,6990252,5088136,1902116
2010-12-18,4,data,1331436,2239200,-907764
2010-12-18,5,data,8058720,4582230,3476490
2010-12-18,6,data,804772,6987221,-6182449
2010-12-18,7,data,4007041,7388314,-3381273
2010-12-18,8,data,6749524,1116228,5633296
2010-12-18,9,data,9153875,2784946,6368929
2010-12-18,10,data,1255284,3500442,-2245158
2010-12-18,11,data,4454533,3968769,485764
2010-12-18,12,data,4511795,8442901,-3931106
2010-12-18,13,data,5683966,2375121,3308845
2010-12-18,14,data,4776406,4957919,-181513
2010-12-18,15,data,5197175,8486846,-3289671
2010-12-18,16,data,6541010,5606279,934731
2010-12-18,17,data,8713334,3733785,4979549
2010-12-18,18,data,4282305,9101252,-4818947
2010-12-18,19,data,832325,5776007,-4943682
2010-12-18,20,data,3294411,1011006,2283405
2010-12-18,21,data,5621478,7502254,-1880776
2010-12-18,22,data,2869511,7472900,-4603389
2010-12-18,23,data,1172711,5513836,-4341125
2010-12-18,0,voice,4055067,9999016,-5943949
2010-12-18,1,voice,1732790,8061777,-6328987
2010-12-18,2,voice,7070715,7196120,-125405
2010-12-18,3,voice,3383817,7019177,-3635360
2010-12-18,4,voice,8020931,6406493,1614438
2010-12-18,5,voice,1637746,5624636,-3986890
2010-12-18,6,voice,5292986,4832952,460034
2010-12-18,7,voice,3233826,717388,2516438
2010-12-18,8,voice,6822592,5329170,1493422
2010-12-18,9,voice,7234349,4952930,2281419
2010-12-18,10,voice,7393717,2823999,4569718
2010-12-18,11,voice,7401867,5029715,2372152
2010-12-18,12,voice,9276005,5851529,3424476
2010-12-18,13,voice,2203836,1200165,1003671
2010-12-18,14,voice,8385775,7830761,555014
2010-12-18,15,voice,5451105,9626296,-4175191
2010-12-18,16,voice,4300153,9465624,-5165471
2010-12-18,17,voice,4823934,4302917,521017
2010-12-18,18,voice,7833466,9830109,-1996643
2010-12-18,19,voice,1708162,1127571,580591
2010-12-18,20,voice,8440765,1183380,7257385
2010-12-18,21,voice,721006,6673364,-5952358
2010-12-18,22,voice,5951579,1454742,4496837
2010-12-18,23,voice,1796375,5039202,-3242827
2010-12-18,0,sms,2833559,1473047,1360512
2010-12-18,1,sms,3494937,712612,2782325
2010-12-18,2,sms,6303445,5772996,530449
2010-12-18,3,sms,5410462,6817655,-1407193
2010-12-18,4,sms,4095902,5999636,-1903734
2010-12-18,5,sms,1945788,8223307,-6277519
2010-12-18,6,sms,5634968,1868556,3766412
2010-12-18,7,sms,1671016,4966460,-3295444
2010-12-18,8,sms,5601310,9305798,-3704488
2010-12-18,9,sms,278972,8821431,-8542459
2010-12-18,10,sms,2559352,5194770,-2635418
2010-12-18,11,sms,2177432,8002506,-5825074
2010-12-18,12,sms,1224402,6755301,-5530899
2010-12-18,13,sms,7600937,8172978,-572041
2010-12-18,14,sms,1751600,1120263,631337
2010-12-18,15,sms,3644879,8067325,-4422446
2010-12-18,16,sms,581405,3844608,-3263203
2010-12-18,17,sms,2266311,655156,1611155
2010-12-18,18,sms,3222792,2131361,1091431
2010-12-18,19,sms,2206098,3649473,-1443375
2010-12-18,20,sms,3573197,3900494,-327297
2010-12-18,21,sms,4683485,3481850,1201635
2010-12-18,22,sms,46648,1329273,-1282625
2010-12-18,23,sms,731320,2301832,-1570512
2010-12-18,0,clr,2297195,1139305,1157890
2010-12-18,1,clr,8477864,9071628,-593764
2010-12-18,2,clr,3888272,1598888,2289384
2010-12-18,3,clr,8554923,2538014,6016909
2010-12-18,4,clr,5548455,2866462,2681993
2010-12-18,5,clr,3416547,2583276,833271
2010-12-18,6,clr,225762,4558917,-4333155
2010-12-18,7,clr,1801736,2833949,-1032213
2010-12-18,8,clr,6955593,4964000,1991593
2010-12-18,9,clr,616133,9698654,-9082521
2010-12-18,10,clr,3570645,5996735,-2426090
2010-12-18,11,clr,3871187,5961655,-2090468
2010-12-18,12,clr,7274340,5411396,1862944
2010-12-18,13,clr,1009304,6732075,-5722771
2010-12-18,14,clr,9471097,7570849,1900248
2010-12-18,15,clr,9012267,9636425,-624158
2010-12-18,16,clr,9848122,521588,9326534
2010-12-18,17,clr,7962877,3818560,4144317
2010-12-18,18,clr,4420579,211571,4209008
2010-12-18,19,clr,7546093,7719604,-173511
2010-12-18,20,clr,4121121,4631240,-510119
2010-12-18,21,clr,5288561,8400755,-3112194
2010-12-18,22,clr,1060120,6706682,-5646562
2010-12-18,23,clr,9018190,5842875,3175315
2010-12-19,0,com,1424257,790198,634059
2010-12-19,1,com,9259249,1486984,7772265
2010-12-19,2,com,5372388,6901090,-1528702
2010-12-19,3,com,8257828,1342754,6915074
2010-12-19,4,com,2382172,4100985,-1718813
2010-12-19,5,com,1193841,3528219,-2334378
2010-12-19,6,com,4333575,9860147,-5526572
2010-12-19,7,com,5670900,3105824,2565076
2010-12-19,8,com,7774717,658508,7116209
2010-12-19,9,com,6229682,9415258,-3185576
2010-12-19,10,com,3366280,2906260,460020
2010-12-19,11,com,7901047,1008038,6893009
2010-12-19,12,com,3949237,8227352,-4278115
2010-12-19,13,com,7153454,6965941,187513
2010-12-19,14,com,4165441,4172776,-7335
2010-12-19,15,com,3218158,6593999,-3375841
2010-12-19,16,com,6209466,1721475,4487991
2010-12-19,17,com,9781199,2189460,7591739
2010-12-19,18,com,7078412,4178578,2899834
2010-12-19,19,com,4402790,5625877,-1223087
2010-12-19,20,com,4841020,4119861,721159
2010-12-19,21,com,5087705,3097965,1989740
2010-12-19,22,com,1471416,6526825,-5055409
2010-12-19,23,com,8571102,7637774,933328
2010-12-19,0,vou,1326638,1753634,-426996
2010-12-19,1,vou,282217,8679659,-8397442
2010-12-19,2,vou,4084780,2850482,1234298
2010-12-19,3,vou,4663224,304125,4359099
2010-12-19,4,vou,3018473,6004227,-2985754
2010-12-19,5,vou,9317821,2933657,6384164
2010-12-19,6,vou,7944648,3582229,4362419
2010-12-19,7,vou,5899584,6864802,-965218
2010-12-19,8,vou,3942212,5783854,-1841642
2010-12-19,9,vou,3839119,651405,3187714
2010-12-19,10,vou,796785,6077297,-5280512
2010-12-19,11,vou,9773494,3584461,6189033
2010-12-19,12,vou,7438696,5789799,1648897
2010-12-19,13,vou,2573042,933211,1639831
2010-12-19,14,vou,3748497,5056688,-1308191
2010-12-19,15,vou,3518996,4000696,-481700
2010-12-19,16,vou,6474127,9845415,-3371288
2010-12-19,17,vou,7803686,3231880,4571806
2010-12-19,18,vou,2341832,5932805,-3590973
2010-12-19,19,vou,8237664,563834,7673830
2010-12-19,20,vou,4682698,2747841,1934857
2010-12-19,21,vou,3744279,8824625,-5080346
2010-12-19,22,vou,1365966,2184816,-818850
2010-12-19,23,vou,2899886,4118260,-1218374
2010-12-19,0,cm,1022623,9524393,-8501770
2010-12-19,1,cm,65955,4458895,-4392940
2010-12-19,2,cm,1841736,3824598,-1982862
2010-12-19,3,cm,3041306,1994914,1046392
2010-12-19,4,cm,5650633,8135474,-2484841
2010-12-19,5,cm,648658,7146854,-6498196
2010-12-19,6,cm,7165657,4290124,2875533
2010-12-19,7,cm,2566035,5353735,-2787700
2010-12-19,8,cm,9228211,2056360,7171851
2010-12-19,9,cm,7676909,1880272,5796637
2010-12-19,10,cm,7600415,854549,6745866
2010-12-19,11,cm,7532861,6485913,1046948
2010-12-19,12,cm,1742097,7700810,-5958713
2010-12-19,13,cm,8032491,9137850,-1105359
2010-12-19,14,cm,6480294,152874,6327420
2010-12-19,15,cm,9936287,4082420,5853867
2010-12-19,16,cm,4532795,3782401,750394
2010-12-19,17,cm,6626870,8338020,-1711150
2010-12-19,18,cm,8050266,2474922,5575344
2010-12-19,19,cm,4201473,8599125,-4397652
2010-12-19,20,cm,8337811,575811,7762000
2010-12-19,21,cm,4126924,4271482,-144558
2010-12-19,22,cm,4438725,4235529,203196
2010-12-19,23,cm,289981,358894,-68913
2010-12-19,0,adj,7782327,8143756,-361429
2010-12-19,1,adj,9348762,5055293,4293469
2010-12-19,2,adj,3149087,6697864,-3548777
2010-12-19,3,adj,1100041,1162898,-62857
2010-12-19,4,adj,7177337,459829,6717508
2010-12-19,5,adj,8171263,5276254,2895009
2010-12-19,6,adj,3969051,4093808,-124757
2010-12-19,7,adj,5959862,3273377,2686485
2010-12-19,8,adj,4743216,9055533,-4312317
2010-12-19,9,adj,6061603,4948379,1113224
2010-12-19,10,adj,9676995,1606677,8070318
2010-12-19,11,adj,8346276,3210686,5135590
2010-12-19,12,adj,6317721,8161795,-1844074
2010-12-19,13,adj,1130218,2672347,-1542129
2010-12-19,14,adj,1019410,3292303,-2272893
2010-12-19,15,adj,1389103,9088619,-7699516
2010-12-19,16,adj,1554253,8819886,-7265633
2010-12-19,17,adj,5096257,8101490,-3005233
2010-12-19,18,adj,609204,2531526,-1922322
2010-12-19,19,adj,4459643,8848683,-4389040
2010-12-19,20,adj,4744391,7289469,-2545078
2010-12-19,21,adj,4789724,3182732,1606992
2010-12-19,22,adj,2249666,1613020,636646
2010-12-19,23,adj,3717728,6259733,-2542005
2010-12-19,0,first,1411805,3693455,-2281650
2010-12-19,1,first,185991,2592761,-2406770
2010-12-19,2,first,6837243,6771359,65884
2010-12-19,3,first,1256428,6299203,-5042775
2010-12-19,4,first,2834704,6634908,-3800204
2010-12-19,5,first,4566112,6403868,-1837756
2010-12-19,6,first,5822906,2248202,3574704
2010-12-19,7,first,6526759,122081,6404678
2010-12-19,8,first,6759989,7750637,-990648
2010-12-19,9,first,3490309,2286420,1203889
2010-12-19,10,first,8530056,4955073,3574983
2010-12-19,11,first,8044739,3653785,4390954
2010-12-19,12,first,8979803,8587787,392016
2010-12-19,13,first,6084973,4272574,1812399
2010-12-19,14,first,4759837,6564253,-1804416
2010-12-19,15,first,7856903,8998152,-1141249
2010-12-19,16,first,6774080,220570,6553510
2010-12-19,17,first,4759504,9614793,-4855289
2010-12-19,18,first,1801457,6369925,-4568468
2010-12-19,19,first,6270513,8216725,-1946212
2010-12-19,20,first,1489217,7763596,-6274379
2010-12-19,21,first,4719482,5683016,-963534
2010-12-19,22,first,4263487,3839955,423532
2010-12-19,23,first,5156399,5428817,-272418
2010-12-19,0,mon,4635136,9411715,-4776579
2010-12-19,1,mon,4682369,6447774,-1765405
2010-12-19,2,mon,911556,7255048,-6343492
2010-12-19,3,mon,832725,595558,237167
2010-12-19,4,mon,499284,7185093,-6685809
2010-12-19,5,mon,243956,4126120,-3882164
2010-12-19,6,mon,7662931,9036960,-1374029
2010-12-19,7,mon,1149052,102019,1047033
2010-12-19,8,mon,9768889,7548555,2220334
2010-12-19,9,mon,3474954,4539743,-1064789
2010-12-19,10,mon,7379122,6885511,493611
2010-12-19,11,mon,8052629,8254023,-201394
2010-12-19,12,mon,7377628,7060615,317013
2010-12-19,13,mon,1777908,693749,1084159
2010-12-19,14,mon,7787483,3287217,4500266
2010-12-19,15,mon,1306387,8871293,-7564906
2010-12-19,16,mon,7400437,6099518,1300919
2010-12-19,17,mon,1548961,8370005,-6821044
2010-12-19,18,mon,8734089,6252643,2481446
2010-12-19,19,mon,3424711,1708017,1716694
2010-12-19,20,mon,8370918,8026321,344597
2010-12-19,21,mon,895700,4832660,-3936960
2010-12-19,22,mon,1651479,7652786,-6001307
2010-12-19,23,mon,4458191,6267820,-1809629
2010-12-19,0,data,9414508,6842149,2572359
2010-12-19,1,data,981569,2211348,-1229779
2010-12-19,2,data,3573161,4293808,-720647
2010-12-19,3,data,5701510,4420539,1280971
2010-12-19,4,data,7608688,419965,7188723
2010-12-19,5,data,4228092,600046,3628046
2010-12-19,6,data,4148527,2917239,1231288
2010-12-19,7,data,5583739,1680922,3902817
2010-12-19,8,data,4340570,6405491,-2064921
2010-12-19,9,data,9144269,3213477,5930792
2010-12-19,10,data,4907276,7856659,-2949383
2010-12-19,11,data,1223611,3147305,-1923694
2010-12-19,12,data,2134954,8782081,-6647127
2010-12-19,13,data,1968506,7783909,-5815403
2010-12-19,14,data,3890987,5359234,-1468247
2010-12-19,15,data,4868288,8214287,-3345999
2010-12-19,16,data,645513,2084869,-1439356
2010-12-19,17,data,4981319,3592879,1388440
2010-12-19,18,data,9517618,919054,8598564
2010-12-19,19,data,7505034,599421,6905613
2010-12-19,20,data,6582152,5447996,1134156
2010-12-19,21,data,2310551,9523053,-7212502
2010-12-19,22,data,300792,3424329,-3123537
2010-12-19,23,data,6052348,371647,5680701
2010-12-19,0,voice,4571254,8612594,-4041340
2010-12-19,1,voice,4459470,9653243,-5193773
2010-12-19,2,voice,2769191,3902615,-1133424
2010-12-19,3,voice,1375976,5270536,-3894560
2010-12-19,4,voice,5255878,8032974,-2777096
2010-12-19,5,voice,1132032,9003540,-7871508
2010-12-19,6,voice,3005293,3277524,-272231
2010-12-19,7,voice,6929730,8411362,-1481632
2010-12-19,8,voice,9364603,2956224,6408379
2010-12-19,9,voice,3441622,4763560,-1321938
2010-12-19,10,voice,3192055,9455423,-6263368
2010-12-19,11,voice,877992,2536596,-1658604
2010-12-19,12,voice,1732144,6486727,-4754583
2010-12-19,13,voice,5999500,1151690,4847810
2010-12-19,14,voice,2272724,5958223,-3685499
2010-12-19,15,voice,1622019,9988712,-8366693
2010-12-19,16,voice,86017,5012263,-4926246
2010-12-19,17,voice,3981596,833147,3148449
2010-12-19,18,voice,4643082,2864297,1778785
2010-12-19,19,voice,8873336,9222916,-349580
2010-12-19,20,voice,4459036,8390234,-3931198
2010-12-19,21,voice,7430577,4037647,3392930
2010-12-19,22,voice,5821959,2447157,3374802
2010-12-19,23,voice,5122615,5688789,-566174
2010-12-19,0,sms,5366375,9104627,-3738252
2010-12-19,1,sms,8257230,5072744,3184486
2010-12-19,2,sms,8857438,3688683,5168755
2010-12-19,3,sms,4646106,25704,4620402
2010-12-19,4,sms,4627455,4892159,-264704
2010-12-19,5,sms,967303,589173,378130
2010-12-19,6,sms,8434615,8369362,65253
2010-12-19,7,sms,6723783,8253679,-1529896
2010-12-19,8,sms,2520577,8328339,-5807762
2010-12-19,9,sms,5158594,4803990,354604
2010-12-19,10,sms,2157988,326105,1831883
2010-12-19,11,sms,8017123,8943685,-926562
2010-12-19,12,sms,6915903,1328904,5586999
2010-12-19,13,sms,6088941,5932086,156855
2010-12-19,14,sms,8209320,1902050,6307270
2010-12-19,15,sms,1297178,7062300,-5765122
2010-12-19,16,sms,5137781,7790899,-2653118
2010-12-19,17,sms,4059057,7019974,-2960917
2010-12-19,18,sms,8913560,5500985,3412575
2010-12-19,19,sms,8236623,2727467,5509156
2010-12-19,20,sms,6401771,6563244,-161473
2010-12-19,21,sms,7681894,3340924,4340970
2010-12-19,22,sms,5400681,7114458,-1713777
2010-12-19,23,sms,4566601,555651,4010950
2010-12-19,0,clr,7624055,5565316,2058739
2010-12-19,1,clr,6787551,6679914,107637
2010-12-19,2,clr,5167927,7740476,-2572549
2010-12-19,3,clr,5133218,7090524,-1957306
2010-12-19,4,clr,8387921,8125917,262004
2010-12-19,5,clr,8840818,1321908,7518910
2010-12-19,6,clr,524364,4733106,-4208742
2010-12-19,7,clr,1139403,7793665,-6654262
2010-12-19,8,clr,3642203,1588762,2053441
2010-12-19,9,clr,4897231,9735151,-4837920
2010-12-19,10,clr,3907612,1696455,2211157
2010-12-19,11,clr,754648,3723680,-2969032
2010-12-19,12,clr,588348,2284204,-1695856
2010-12-19,13,clr,6843513,3454840,3388673
2010-12-19,14,clr,3073899,9129177,-6055278
2010-12-19,15,clr,790749,7755004,-6964255
2010-12-19,16,clr,3097426,7318219,-4220793
2010-12-19,17,clr,6125629,5198400,927229
2010-12-19,18,clr,5096230,5809749,-713519
2010-12-19,19,clr,3865828,8343623,-4477795
2010-12-19,20,clr,3836598,8839992,-5003394
2010-12-19,21,clr,8349206,4201152,4148054
2010-12-19,22,clr,6422728,1952909,4469819
2010-12-19,23,clr,1270332,6845997,-5575665
2010-12-20,0,com,6395801,6287921,107880
2010-12-20,1,com,8239311,6548799,1690512
2010-12-20,2,com,9506090,7774692,1731398
2010-12-20,3,com,4905466,1532685,3372781
2010-12-20,4,com,5479805,507613,4972192
2010-12-20,5,com,4669538,1676170,2993368
2010-12-20,6,com,9047741,6359417,2688324
2010-12-20,7,com,2681859,7714241,-5032382
2010-12-20,8,com,3949584,4848643,-899059
2010-12-20,9,com,8397112,1914172,6482940
2010-12-20,10,com,7422349,3087340,4335009
2010-12-20,11,com,6260121,8337163,-2077042
2010-12-20,12,com,4705962,5892730,-1186768
2010-12-20,13,com,4542767,3442395,1100372
2010-12-20,14,com,5840649,6583767,-743118
2010-12-20,15,com,7806520,2667514,5139006
2010-12-20,16,com,6057107,8776056,-2718949
2010-12-20,17,com,3214245,1285411,1928834
2010-12-20,18,com,3024557,8607022,-5582465
2010-12-20,19,com,985950,3992682,-3006732
2010-12-20,20,com,9640908,2936022,6704886
2010-12-20,21,com,2262052,2310562,-48510
2010-12-20,22,com,3219653,8131977,-4912324
2010-12-20,23,com,7049054,3767624,3281430
2010-12-20,0,vou,5305343,1094644,4210699
2010-12-20,1,vou,353365,9461516,-9108151
2010-12-20,2,vou,5301363,8415213,-3113850
2010-12-20,3,vou,2212264,9894847,-7682583
2010-12-20,4,vou,9213437,1168440,8044997
2010-12-20,5,vou,2464756,8118631,-5653875
2010-12-20,6,vou,8040011,7001415,1038596
2010-12-20,7,vou,9733464,186527,9546937
2010-12-20,8,vou,822206,4699685,-3877479
2010-12-20,9,vou,4441334,5292182,-850848
2010-12-20,10,vou,6608604,4049746,2558858
2010-12-20,11,vou,7467104,9261720,-1794616
2010-12-20,12,vou,3737502,7074058,-3336556
2010-12-20,13,vou,5227938,3127442,2100496
2010-12-20,14,vou,1905374,5823331,-3917957
2010-12-20,15,vou,46881,9771303,-9724422
2010-12-20,16,vou,9762541,9467120,295421
2010-12-20,17,vou,6951053,1499243,5451810
2010-12-20,18,vou,5623991,4845614,778377
2010-12-20,19,vou,1450472,5386245,-3935773
2010-12-20,20,vou,8567802,5762779,2805023
2010-12-20,21,vou,3875636,4522359,-646723
2010-12-20,22,vou,5523913,2743761,2780152
2010-12-20,23,vou,4640557,991793,3648764
2010-12-20,0,cm,9797719,550705,9247014
2010-12-20,1,cm,9150574,6072853,3077721
2010-12-20,2,cm,1762321,8033615,-6271294
2010-12-20,3,cm,6349608,8431679,-2082071
2010-12-20,4,cm,1364115,6529303,-5165188
2010-12-20,5,cm,3202287,4642839,-1440552
2010-12-20,6,cm,8175025,5757728,2417297
2010-12-20,7,cm,2621333,4334161,-1712828
2010-12-20,8,cm,385780,7202925,-6817145
2010-12-20,9,cm,5583759,9691645,-4107886
2010-12-20,10,cm,3663145,5966530,-2303385
2010-12-20,11,cm,2562081,1302612,1259469
2010-12-20,12,cm,1027315,4492182,-3464867
2010-12-20,13,cm,1397168,296157,1101011
2010-12-20,14,cm,8987700,5190606,3797094
2010-12-20,15,cm,6963019,8469393,-1506374
2010-12-20,16,cm,2932203,6291696,-3359493
2010-12-20,17,cm,3852373,652800,3199573
2010-12-20,18,cm,4084532,6616384,-2531852
2010-12-20,19,cm,8405349,4510769,3894580
2010-12-20,20,cm,9227157,9696198,-469041
2010-12-20,21,cm,2655562,8960280,-6304718
2010-12-20,22,cm,5356187,6846188,-1490001
2010-12-20,23,cm,4112710,245673,3867037
2010-12-20,0,adj,9366037,7403668,1962369
2010-12-20,1,adj,1238277,4051716,-2813439
2010-12-20,2,adj,3242316,5150242,-1907926
2010-12-20,3,adj,705104,8219725,-7514621
2010-12-20,4,adj,5954811,484598,5470213
2010-12-20,5,adj,1463528,4336167,-2872639
2010-12-20,6,adj,5651954,1992482,3659472
2010-12-20,7,adj,1421370,6398581,-4977211
2010-12-20,8,adj,5297233,4946615,350618
2010-12-20,9,adj,2330394,688838,1641556
2010-12-20,10,adj,2365160,2761396,-396236
2010-12-20,11,adj,7461690,6833678,628012
2010-12-20,12,adj,2132334,9486479,-7354145
2010-12-20,13,adj,5689912,9701948,-4012036
2010-12-20,14,adj,6910596,6378176,532420
2010-12-20,15,adj,1483352,5057552,-3574200
2010-12-20,16,adj,4138108,7240183,-3102075
2010-12-20,17,adj,5460392,3099265,2361127
2010-12-20,18,adj,1337226,3054284,-1717058
2010-12-20,19,adj,4667751,2108772,2558979
2010-12-20,20,adj,804080,9462750,-8658670
2010-12-20,21,adj,982889,5136917,-4154028
2010-12-20,22,adj,6117842,6320980,-203138
2010-12-20,23,adj,6817856,5575263,1242593
2010-12-20,0,first,6625736,8796674,-2170938
2010-12-20,1,first,12777,7880018,-7867241
2010-12-20,2,first,4338929,2398318,1940611
2010-12-20,3,first,8408281,4678312,3729969
2010-12-20,4,first,9544931,1171374,8373557
2010-12-20,5,first,2409854,3358404,-948550
2010-12-20,6,first,5094741,9766314,-4671573
2010-12-20,7,first,1495816,8404124,-6908308
2010-12-20,8,first,4142185,1634906,2507279
2010-12-20,9,first,9705951,7998276,1707675
2010-12-20,10,first,9275302,3590205,5685097
2010-12-20,11,first,2130878,5822150,-3691272
2010-12-20,12,first,3515988,5900488,-2384500
2010-12-20,13,first,2921791,2719769,202022
2010-12-20,14,first,1536117,7751950,-6215833
2010-12-20,15,first,9646992,9003525,643467
2010-12-20,16,first,5271115,9345626,-4074511
2010-12-20,17,first,8468917,9192598,-723681
2010-12-20,18,first,5109278,3226861,1882417
2010-12-20,19,first,8897584,3493209,5404375
2010-12-20,20,first,5392317,1607139,3785178
2010-12-20,21,first,7581617,3584158,3997459
2010-12-20,22,first,3908719,2821925,1086794
2010-12-20,23,first,4085606,8743197,-4657591
2010-12-20,0,mon,4778494,5823929,-1045435
2010-12-20,1,mon,7005588,4281211,2724377
2010-12-20,2,mon,2124306,9091041,-6966735
2010-12-20,3,mon,8007753,4174353,3833400
2010-12-20,4,mon,6802954,9548426,-2745472
2010-12-20,5,mon,5781962,8178263,-2396301
2010-12-20,6,mon,3730766,3069620,661146
2010-12-20,7,mon,5518028,3315544,2202484
2010-12-20,8,mon,4202228,3383781,818447
2010-12-20,9,mon,2265988,7952486,-5686498
2010-12-20,10,mon,3456105,3555560,-99455
2010-12-20,11,mon,316834,8162194,-7845360
2010-12-20,12,mon,8913952,4783807,4130145
2010-12-20,13,mon,8299770,301209,7998561
2010-12-20,14,mon,4404944,7970664,-3565720
2010-12-20,15,mon,3017148,8074234,-5057086
2010-12-20,16,mon,5139130,1874768,3264362
2010-12-20,17,mon,4525471,5761120,-1235649
2010-12-20,18,mon,4621085,7127560,-2506475
2010-12-20,19,mon,1603507,2324144,-720637
2010-12-20,20,mon,8998955,7452430,1546525
2010-12-20,21,mon,5519194,3483723,2035471
2010-12-20,22,mon,6152280,3479533,2672747
2010-12-20,23,mon,6871558,7879743,-1008185
2010-12-20,0,data,5676815,4894084,782731
2010-12-20,1,data,3869046,9671773,-5802727
2010-12-20,2,data,9822621,2895422,6927199
2010-12-20,3,data,9494425,5053433,4440992
2010-12-20,4,data,6264250,6986308,-722058
2010-12-20,5,data,2180654,6522063,-4341409
2010-12-20,6,data,3555674,7886718,-4331044
2010-12-20,7,data,7585655,2136072,5449583
2010-12-20,8,data,1827743,3690323,-1862580
2010-12-20,9,data,9465328,3989935,5475393
2010-12-20,10,data,617437,8586411,-7968974
2010-12-20,11,data,3916471,3537977,378494
2010-12-20,12,data,3958180,8672790,-4714610
2010-12-20,13,data,1211379,5120118,-3908739
2010-12-20,14,data,6543477,91849,6451628
2010-12-20,15,data,9987371,6102394,3884977
2010-12-20,16,data,8278217,2256482,6021735
2010-12-20,17,data,9676917,9646806,30111
2010-12-20,18,data,8490475,5804285,2686190
2010-12-20,19,data,3205,1076021,-1072816
2010-12-20,20,data,6698606,8993019,-2294413
2010-12-20,21,data,9774574,4410768,5363806
2010-12-20,22,data,2444370,7794577,-5350207
2010-12-20,23,data,4641095,1452248,3188847
2010-12-20,0,voice,8505032,3517543,4987489
2010-12-20,1,voice,847233,6267022,-5419789
2010-12-20,2,voice,3407677,7277412,-3869735
2010-12-20,3,voice,8614420,762372,7852048
2010-12-20,4,voice,7882558,8681895,-799337
2010-12-20,5,voice,9636925,7975945,1660980
2010-12-20,6,voice,4986212,8511257,-3525045
2010-12-20,7,voice,5570719,7517087,-1946368
2010-12-20,8,voice,6663709,5840482,823227
2010-12-20,9,voice,2323444,6278759,-3955315
2010-12-20,10,voice,6946012,1786605,5159407
2010-12-20,11,voice,5779830,5257828,522002
2010-12-20,12,voice,5986951,246485,5740466
2010-12-20,13,voice,312345,7820113,-7507768
2010-12-20,14,voice,4734543,9255158,-4520615
2010-12-20,15,voice,7263686,1636244,5627442
2010-12-20,16,voice,9961068,1585643,8375425
2010-12-20,17,voice,3706037,145596,3560441
2010-12-20,18,voice,5511454,9950491,-4439037
2010-12-20,19,voice,282672,3664376,-3381704
2010-12-20,20,voice,2335131,9965633,-7630502
2010-12-20,21,voice,5760636,7044065,-1283429
2010-12-20,22,voice,9398542,1679984,7718558
2010-12-20,23,voice,575023,5781196,-5206173
2010-12-20,0,sms,8472364,2602060,5870304
2010-12-20,1,sms,3080805,9138939,-6058134
2010-12-20,2,sms,8529667,9650251,-1120584
2010-12-20,3,sms,4462240,5926883,-1464643
2010-12-20,4,sms,5321492,9697392,-4375900
2010-12-20,5,sms,5485765,7486448,-2000683
2010-12-20,6,sms,6169701,7142305,-972604
2010-12-20,7,sms,9225345,9997222,-771877
2010-12-20,8,sms,3393613,5949228,-2555615
2010-12-20,9,sms,324206,1635294,-1311088
2010-12-20,10,sms,1982046,3503682,-1521636
2010-12-20,11,sms,7133993,1151788,5982205
2010-12-20,12,sms,8840906,8151489,689417
2010-12-20,13,sms,1673853,2463550,-789697
2010-12-20,14,sms,1961912,1379252,582660
2010-12-20,15,sms,1779487,1853990,-74503
2010-12-20,16,sms,5028043,1648013,3380030
2010-12-20,17,sms,5770877,2490981,3279896
2010-12-20,18,sms,7589202,6804660,784542
2010-12-20,19,sms,9763184,1938303,7824881
2010-12-20,20,sms,163811,8154822,-7991011
2010-12-20,21,sms,4272576,8221242,-3948666
2010-12-20,22,sms,2074614,241239,1833375
2010-12-20,23,sms,791600,8359191,-7567591
2010-12-20,0,clr,9332758,1918968,7413790
2010-12-20,1,clr,8884402,2654628,6229774
2010-12-20,2,clr,578199,4119006,-3540807
2010-12-20,3,clr,1190503,2217755,-1027252
2010-12-20,4,clr,6088428,1401960,4686468
2010-12-20,5,clr,4614497,2202871,2411626
2010-12-20,6,clr,3395222,5351548,-1956326
2010-12-20,7,clr,2024254,3498619,-1474365
2010-12-20,8,clr,543842,8477340,-7933498
2010-12-20,9,clr,5330915,8469473,-3138558
2010-12-20,10,clr,955205,8432540,-7477335
2010-12-20,11,clr,3802365,6556387,-2754022
2010-12-20,12,clr,8635165,3953785,4681380
2010-12-20,13,clr,6527572,3199095,3328477
2010-12-20,14,clr,853251,1540755,-687504
2010-12-20,15,clr,7863126,8084854,-221728
2010-12-20,16,clr,244452,8017824,-7773372
2010-12-20,17,clr,2488057,8699682,-6211625
2010-12-20,18,clr,7811767,9454147,-1642380
2010-12-20,19,clr,8623790,2498937,6124853
2010-12-20,20,clr,5670951,8253974,-2583023
2010-12-20,21,clr,216856,156461,60395
2010-12-20,22,clr,5400929,9270809,-3869880
2010-12-20,23,clr,5589576,6328180,-738604
2010-12-21,0,com,7976059,3265741,4710318
2010-12-21,1,com,6342007,3897744,2444263
2010-12-21,2,com,8801465,8187336,614129
2010-12-21,3,com,5192022,7275660,-2083638
2010-12-21,4,com,4791342,6122030,-1330688
2010-12-21,5,com,9852119,1305317,8546802
2010-12-21,6,com,1690102,8398348,-6708246
2010-12-21,7,com,2462218,5857032,-3394814
2010-12-21,8,com,867376,923343,-55967
2010-12-21,9,com,3385333,4913034,-1527701
2010-12-21,10,com,5539380,6093932,-554552
2010-12-21,11,com,4157632,2623334,1534298
2010-12-21,12,com,6778286,5273469,1504817
2010-12-21,13,com,5245439,1760640,3484799
2010-12-21,14,com,6154071,6545958,-391887
2010-12-21,15,com,2224288,7450753,-5226465
2010-12-21,16,com,4369292,9141780,-4772488
2010-12-21,17,com,8361548,997168,7364380
2010-12-21,18,com,9915088,7996618,1918470
2010-12-21,19,com,9000336,5085999,3914337
2010-12-21,20,com,214715,5806527,-5591812
2010-12-21,21,com,2653507,8892109,-6238602
2010-12-21,22,com,2688192,903322,1784870
2010-12-21,23,com,919958,6377928,-5457970
2010-12-21,0,vou,392348,4762400,-4370052
2010-12-21,1,vou,8127396,2538086,5589310
2010-12-21,2,vou,1652471,1765178,-112707
2010-12-21,3,vou,3491967,9954341,-6462374
2010-12-21,4,vou,4488736,4644118,-155382
2010-12-21,5,vou,6064010,2336320,3727690
2010-12-21,6,vou,4568218,4262842,305376
2010-12-21,7,vou,7985591,1007008,6978583
2010-12-21,8,vou,1773874,6651961,-4878087
2010-12-21,9,vou,7336120,9135092,-1798972
2010-12-21,10,vou,4235039,1136660,3098379
2010-12-21,11,vou,9125166,5522792,3602374
2010-12-21,12,vou,2080981,3689294,-1608313
2010-12-21,13,vou,1652420,7256762,-5604342
2010-12-21,14,vou,1811195,1149025,662170
2010-12-21,15,vou,6450059,547226,5902833
2010-12-21,16,vou,6492546,7486067,-993521
2010-12-21,17,vou,5264295,3744748,1519547
2010-12-21,18,vou,7133929,7384327,-250398
2010-12-21,19,vou,3934550,311401,3623149
2010-12-21,20,vou,2367092,9098011,-6730919
2010-12-21,21,vou,2060369,7772436,-5712067
2010-12-21,22,vou,6148825,8413973,-2265148
2010-12-21,23,vou,2243626,2139597,104029
2010-12-21,0,cm,7679576,7243549,436027
2010-12-21,1,cm,2941145,5081363,-2140218
2010-12-21,2,cm,2237377,9859535,-7622158
2010-12-21,3,cm,543384,1248,542136
2010-12-21,4,cm,8291131,1076226,7214905
2010-12-21,5,cm,742521,4622773,-3880252
2010-12-21,6,cm,7439245,7465037,-25792
2010-12-21,7,cm,2744068,4921304,-2177236
2010-12-21,8,cm,4919308,5540447,-621139
2010-12-21,9,cm,4960678,3996112,964566
2010-12-21,10,cm,2122240,65292,2056948
2010-12-21,11,cm,7837707,7691774,145933
2010-12-21,12,cm,6953860,1551766,5402094
2010-12-21,13,cm,4023041,5992781,-1969740
2010-12-21,14,cm,3964501,5406500,-1441999
2010-12-21,15,cm,712796,5875887,-5163091
2010-12-21,16,cm,4311027,7616535,-3305508
2010-12-21,17,cm,591108,5653652,-5062544
2010-12-21,18,cm,792416,1681565,-889149
2010-12-21,19,cm,8529111,7616151,912960
2010-12-21,20,cm,7225515,7945276,-719761
2010-12-21,21,cm,6429825,7675989,-1246164
2010-12-21,22,cm,4961718,7788214,-2826496
2010-12-21,23,cm,4973779,488621,4485158
2010-12-21,0,adj,4035615,4204762,-169147
2010-12-21,1,adj,6759491,9584700,-2825209
2010-12-21,2,adj,7242470,9857725,-2615255
2010-12-21,3,adj,7235344,7244185,-8841
2010-12-21,4,adj,3001948,1003098,1998850
2010-12-21,5,adj,267350,6546003,-6278653
2010-12-21,6,adj,5058638,5414538,-355900
2010-12-21,7,adj,1475546,4798878,-3323332
2010-12-21,8,adj,4150426,7756291,-3605865
2010-12-21,9,adj,6496133,217657,6278476
2010-12-21,10,adj,3550791,8649368,-5098577
2010-12-21,11,adj,1249937,5385113,-4135176
2010-12-21,12,adj,1840102,7194466,-5354364
2010-12-21,13,adj,3093869,8401618,-5307749
2010-12-21,14,adj,8688237,2104570,6583667
2010-12-21,15,adj,9237279,2751832,6485447
2010-12-21,16,adj,2504776,1078642,1426134
2010-12-21,17,adj,507708,9461914,-8954206
2010-12-21,18,adj,5631557,9474317,-3842760
2010-12-21,19,adj,4880406,4403754,476652
2010-12-21,20,adj,1063632,2555599,-1491967
2010-12-21,21,adj,7586388,1668928,5917460
2010-12-21,22,adj,3080440,8882076,-5801636
2010-12-21,23,adj,8686529,6528679,2157850
2010-12-21,0,first,9410440,6612381,2798059
2010-12-21,1,first,1608775,1416168,192607
2010-12-21,2,first,690182,1347336,-657154
2010-12-21,3,first,5237873,8891988,-3654115
2010-12-21,4,first,1912997,3294446,-1381449
2010-12-21,5,first,4518506,7171588,-2653082
2010-12-21,6,first,7811674,3171773,4639901
2010-12-21,7,first,2498504,4439920,-1941416
2010-12-21,8,first,8134201,7965971,168230
2010-12-21,9,first,8292682,2705321,5587361
2010-12-21,10,first,1252454,5941485,-4689031
2010-12-21,11,first,8033697,8356335,-322638
2010-12-21,12,first,113007,8691546,-8578539
2010-12-21,13,first,2928935,1319405,1609530
2010-12-21,14,first,9845627,6422037,3423590
2010-12-21,15,first,3407132,622164,2784968
2010-12-21,16,first,4320935,7909864,-3588929
2010-12-21,17,first,905675,8631451,-7725776
2010-12-21,18,first,1992940,3193530,-1200590
2010-12-21,19,first,7339579,5851589,1487990
2010-12-21,20,first,2585851,5942698,-3356847
2010-12-21,21,first,1161307,4113642,-2952335
2010-12-21,22,first,3234324,6313943,-3079619
2010-12-21,23,first,2977285,4052605,-1075320
2010-12-21,0,mon,5594594,9548769,-3954175
2010-12-21,1,mon,2506833,9162318,-6655485
2010-12-21,2,mon,7445129,3644012,3801117
2010-12-21,3,mon,8223713,8531490,-307777
2010-12-21,4,mon,2541501,1419691,1121810
2010-12-21,5,mon,1136707,6844697,-5707990
2010-12-21,6,mon,1447855,3998875,-2551020
2010-12-21,7,mon,8414475,4870245,3544230
2010-12-21,8,mon,6760988,7662714,-901726
2010-12-21,9,mon,8977500,3704630,5272870
2010-12-21,10,mon,2702899,6068742,-3365843
2010-12-21,11,mon,1923080,3126365,-1203285
2010-12-21,12,mon,1509542,7476228,-5966686
2010-12-21,13,mon,644640,1934814,-1290174
2010-12-21,14,mon,7666230,5763154,1903076
2010-12-21,15,mon,4577538,2060816,2516722
2010-12-21,16,mon,6554318,4582528,1971790
2010-12-21,17,mon,6968600,9806183,-2837583
2010-12-21,18,mon,7175036,6384688,790348
2010-12-21,19,mon,7488972,8950890,-1461918
2010-12-21,20,mon,757264,9438093,-8680829
2010-12-21,21,mon,3357698,7992279,-4634581
2010-12-21,22,mon,4110273,1343227,2767046
2010-12-21,23,mon,1939211,4177637,-2238426
2010-12-21,0,data,9159943,2751225,6408718
2010-12-21,1,data,9714567,5163484,4551083
2010-12-21,2,data,9845194,3794527,6050667
2010-12-21,3,data,2182182,2021327,160855
2010-12-21,4,data,4220112,2758338,1461774
2010-12-21,5,data,7016153,4785520,2230633
2010-12-21,6,data,74180,9684322,-9610142
2010-12-21,7,data,4904668,8292476,-3387808
2010-12-21,8,data,8624149,9210286,-586137
2010-12-21,9,data,7972449,4725043,3247406
2010-12-21,10,data,881328,6302829,-5421501
2010-12-21,11,data,4726868,3686888,1039980
2010-12-21,12,data,7970818,1663575,6307243
2010-12-21,13,data,6824677,2769672,4055005
2010-12-21,14,data,6349744,6166206,183538
2010-12-21,15,data,8446122,8278257,167865
2010-12-21,16,data,7285346,2498074,4787272
2010-12-21,17,data,8381972,8296816,85156
2010-12-21,18,data,6111135,837112,5274023
2010-12-21,19,data,1877278,4345829,-2468551
2010-12-21,20,data,3236016,3717466,-481450
2010-12-21,21,data,702087,376451,325636
2010-12-21,22,data,9800649,2796508,7004141
2010-12-21,23,data,4196142,869550,3326592
2010-12-21,0,voice,2200781,5221813,-3021032
2010-12-21,1,voice,7765628,7703294,62334
2010-12-21,2,voice,1862326,1317377,544949
2010-12-21,3,voice,6345196,4509665,1835531
2010-12-21,4,voice,7141938,3811403,3330535
2010-12-21,5,voice,3284020,471223,2812797
2010-12-21,6,voice,9823646,6093091,3730555
2010-12-21,7,voice,1257501,3595844,-2338343
2010-12-21,8,voice,2016564,1255207,761357
2010-12-21,9,voice,7350593,8421592,-1070999
2010-12-21,10,voice,731181,7891803,-7160622
2010-12-21,11,voice,3288283,4721174,-1432891
2010-12-21,12,voice,9366644,875298,8491346
2010-12-21,13,voice,5228154,8872439,-3644285
2010-12-21,14,voice,1975388,7978727,-6003339
2010-12-21,15,voice,1846420,472945,1373475
2010-12-21,16,voice,9519070,1736163,7782907
2010-12-21,17,voice,2593873,9527210,-6933337
2010-12-21,18,voice,4671848,5106180,-434332
2010-12-21,19,voice,7404217,7717322,-313105
2010-12-21,20,voice,8002742,8755747,-753005
2010-12-21,21,voice,5155233,601089,4554144
2010-12-21,22,voice,5826699,3718730,2107969
2010-12-21,23,voice,9701549,6098972,3602577
2010-12-21,0,sms,9271654,4201604,5070050
2010-12-21,1,sms,9580949,108592,9472357
2010-12-21,2,sms,143684,5967576,-5823892
2010-12-21,3,sms,1852272,9714654,-7862382
2010-12-21,4,sms,6831137,4578364,2252773
2010-12-21,5,sms,4180672,3824468,356204
2010-12-21,6,sms,4538863,9959840,-5420977
2010-12-21,7,sms,1473216,7532184,-6058968
2010-12-21,8,sms,5621331,587513,5033818
2010-12-21,9,sms,9060179,4467849,4592330
2010-12-21,10,sms,1865458,223132,1642326
2010-12-21,11,sms,5177484,885890,4291594
2010-12-21,12,sms,3742877,7602181,-3859304
2010-12-21,13,sms,6575721,5175522,1400199
2010-12-21,14,sms,2547179,9771168,-7223989
2010-12-21,15,sms,7525721,8696436,-1170715
2010-12-21,16,sms,5939841,1053537,4886304
2010-12-21,17,sms,8993832,6530314,2463518
2010-12-21,18,sms,9201198,8319324,881874
2010-12-21,19,sms,3384246,9108492,-5724246
2010-12-21,20,sms,173989,8246714,-8072725
2010-12-21,21,sms,6778027,4362987,2415040
2010-12-21,22,sms,913939,4121242,-3207303
2010-12-21,23,sms,2050739,7000675,-4949936
2010-12-21,0,clr,6078619,6969473,-890854
2010-12-21,1,clr,5880992,5771152,109840
2010-12-21,2,clr,7502996,4887489,2615507
2010-12-21,3,clr,3129499,3215263,-85764
2010-12-21,4,clr,9417821,4061907,5355914
2010-12-21,5,clr,2740613,7100643,-4360030
2010-12-21,6,clr,6317722,3591082,2726640
2010-12-21,7,clr,8538945,5268514,3270431
2010-12-21,8,clr,6295822,6658864,-363042
2010-12-21,9,clr,9009011,6245463,2763548
2010-12-21,10,clr,9677360,4435028,5242332
2010-12-21,11,clr,6435337,2587529,3847808
2010-12-21,12,clr,8666069,9614429,-948360
2010-12-21,13,clr,5514249,4081221,1433028
2010-12-21,14,clr,9115771,3660133,5455638
2010-12-21,15,clr,6887400,3090277,3797123
2010-12-21,16,clr,1448913,4664179,-3215266
2010-12-21,17,clr,222618,7548707,-7326089
2010-12-21,18,clr,6973554,1551363,5422191
2010-12-21,19,clr,9578624,4141504,5437120
2010-12-21,20,clr,1263323,651567,611756
2010-12-21,21,clr,1288047,2799313,-1511266
2010-12-21,22,clr,8139805,8645135,-505330
2010-12-21,23,clr,1857149,6462599,-4605450
2010-12-22,0,com,1709806,1213121,496685
2010-12-22,1,com,2527897,2553192,-25295
2010-12-22,2,com,2819106,3188323,-369217
2010-12-22,3,com,7716454,9311145,-1594691
2010-12-22,4,com,5038505,6124237,-1085732
2010-12-22,5,com,877804,9774149,-8896345
2010-12-22,6,com,7144698,3186391,3958307
2010-12-22,7,com,3997507,4854828,-857321
2010-12-22,8,com,1683420,9910193,-8226773
2010-12-22,9,com,9984442,1951459,8032983
2010-12-22,10,com,2039256,1878081,161175
2010-12-22,11,com,7213334,6866330,347004
2010-12-22,12,com,3707096,5997246,-2290150
2010-12-22,13,com,1404954,4905827,-3500873
2010-12-22,14,com,5652458,8816181,-3163723
2010-12-22,15,com,8889938,137758,8752180
2010-12-22,16,com,7151557,1103292,6048265
2010-12-22,17,com,3408648,2465318,943330
2010-12-22,18,com,3628105,497953,3130152
2010-12-22,19,com,4459494,1424207,3035287
2010-12-22,20,com,9712930,8055629,1657301
2010-12-22,21,com,4344443,1802808,2541635
2010-12-22,22,com,6948458,3925784,3022674
2010-12-22,23,com,1413354,4650927,-3237573
2010-12-22,0,vou,6758312,2956968,3801344
2010-12-22,1,vou,7362731,7930860,-568129
2010-12-22,2,vou,9191478,6361489,2829989
2010-12-22,3,vou,7404338,6596099,808239
2010-12-22,4,vou,6130191,6728396,-598205
2010-12-22,5,vou,2622847,4577731,-1954884
2010-12-22,6,vou,4182666,621004,3561662
2010-12-22,7,vou,3107325,8722382,-5615057
2010-12-22,8,vou,4384055,1193012,3191043
2010-12-22,9,vou,2337592,3608441,-1270849
2010-12-22,10,vou,5574879,3419294,2155585
2010-12-22,11,vou,1877296,7982332,-6105036
2010-12-22,12,vou,2333293,7367587,-5034294
2010-12-22,13,vou,2997097,666499,2330598
2010-12-22,14,vou,1977315,862892,1114423
2010-12-22,15,vou,8539122,4426657,4112465
2010-12-22,16,vou,1089361,5552263,-4462902
2010-12-22,17,vou,9793786,5663300,4130486
2010-12-22,18,vou,9661518,7419091,2242427
2010-12-22,19,vou,3933747,6552366,-2618619
2010-12-22,20,vou,4319478,3191236,1128242
2010-12-22,21,vou,9532182,4361254,5170928
2010-12-22,22,vou,6178188,6199157,-20969
2010-12-22,23,vou,48932,1713432,-1664500
2010-12-22,0,cm,8953471,8602692,350779
2010-12-22,1,cm,4830665,6805194,-1974529
2010-12-22,2,cm,5785428,974616,4810812
2010-12-22,3,cm,3628199,9459779,-5831580
2010-12-22,4,cm,4718511,1223661,3494850
2010-12-22,5,cm,2298506,5629793,-3331287
2010-12-22,6,cm,5407347,8591611,-3184264
2010-12-22,7,cm,2962597,1399353,1563244
2010-12-22,8,cm,9846262,7912313,1933949
2010-12-22,9,cm,58042,1758101,-1700059
2010-12-22,10,cm,5354554,2718158,2636396
2010-12-22,11,cm,1856075,7780689,-5924614
2010-12-22,12,cm,4418099,2157710,2260389
2010-12-22,13,cm,4702769,5077481,-374712
2010-12-22,14,cm,5647579,7252256,-1604677
2010-12-22,15,cm,7244705,6431430,813275
2010-12-22,16,cm,3792734,5615198,-1822464
2010-12-22,17,cm,9795274,2461619,7333655
2010-12-22,18,cm,5858009,1559510,4298499
2010-12-22,19,cm,6991676,630235,6361441
2010-12-22,20,cm,6552801,8999897,-2447096
2010-12-22,21,cm,8315457,6818840,1496617
2010-12-22,22,cm,3737444,5709648,-1972204
2010-12-22,23,cm,647081,1246871,-599790
2010-12-22,0,adj,1249709,8904930,-7655221
2010-12-22,1,adj,2461881,8697618,-6235737
2010-12-22,2,adj,9103448,4065319,5038129
2010-12-22,3,adj,4554108,672603,3881505
2010-12-22,4,adj,9774485,9994459,-219974
2010-12-22,5,adj,8266487,7097522,1168965
2010-12-22,6,adj,6525459,4025524,2499935
2010-12-22,7,adj,1600402,4911467,-3311065
2010-12-22,8,adj,2530519,1598784,931735
2010-12-22,9,adj,4749651,717493,4032158
2010-12-22,10,adj,9414259,1098694,8315565
2010-12-22,11,adj,961937,57050,904887
2010-12-22,12,adj,720551,8134483,-7413932
2010-12-22,13,adj,508636,5470907,-4962271
2010-12-22,14,adj,1199322,4442880,-3243558
2010-12-22,15,adj,7921644,6068115,1853529
2010-12-22,16,adj,4147174,5214062,-1066888
2010-12-22,17,adj,268673,232882,35791
2010-12-22,18,adj,4183292,3055163,1128129
2010-12-22,19,adj,5799230,8930643,-3131413
2010-12-22,20,adj,6837398,1673715,5163683
2010-12-22,21,adj,9439183,2997769,6441414
2010-12-22,22,adj,1993460,649544,1343916
2010-12-22,23,adj,6981927,5320423,1661504
2010-12-22,0,first,7902208,3422232,4479976
2010-12-22,1,first,8192172,9393978,-1201806
2010-12-22,2,first,1180333,4900705,-3720372
2010-12-22,3,first,5917366,5731885,185481
2010-12-22,4,first,6250771,7162737,-911966
2010-12-22,5,first,8331869,2526541,5805328
2010-12-22,6,first,278292,3803455,-3525163
2010-12-22,7,first,2439900,8976407,-6536507
2010-12-22,8,first,7641668,9489991,-1848323
2010-12-22,9,first,7721761,1898360,5823401
2010-12-22,10,first,8208165,5906791,2301374
2010-12-22,11,first,937825,6002406,-5064581
2010-12-22,12,first,3395695,6903326,-3507631
2010-12-22,13,first,6836520,2959179,3877341
2010-12-22,14,first,843303,5262945,-4419642
2010-12-22,15,first,932334,3346051,-2413717
2010-12-22,16,first,4143858,2971937,1171921
2010-12-22,17,first,2486831,2433867,52964
2010-12-22,18,first,2378128,5236998,-2858870
2010-12-22,19,first,3826767,6162023,-2335256
2010-12-22,20,first,1590382,9454242,-7863860
2010-12-22,21,first,857093,2944319,-2087226
2010-12-22,22,first,19160,5053126,-5033966
2010-12-22,23,first,8891158,6802173,2088985
2010-12-22,0,mon,1839854,3749098,-1909244
2010-12-22,1,mon,1042480,7306762,-6264282
2010-12-22,2,mon,6824380,2986811,3837569
2010-12-22,3,mon,6176848,5036934,1139914
2010-12-22,4,mon,1270620,5215541,-3944921
2010-12-22,5,mon,6749215,7873601,-1124386
2010-12-22,6,mon,11708,3190166,-3178458
2010-12-22,7,mon,9121580,1410046,7711534
2010-12-22,8,mon,1133217,5482213,-4348996
2010-12-22,9,mon,8462311,7177738,1284573
2010-12-22,10,mon,1703998,4951629,-3247631
2010-12-22,11,mon,3884596,1800685,2083911
2010-12-22,12,mon,8562526,9795547,-1233021
2010-12-22,13,mon,6202467,7427454,-1224987
2010-12-22,14,mon,1288447,6079754,-4791307
2010-12-22,15,mon,7854951,4430787,3424164
2010-12-22,16,mon,2160382,5324881,-3164499
2010-12-22,17,mon,3782756,4771298,-988542
2010-12-22,18,mon,9122049,8252103,869946
2010-12-22,19,mon,3016140,8099040,-5082900
2010-12-22,20,mon,69360,8003638,-7934278
2010-12-22,21,mon,972580,6108300,-5135720
2010-12-22,22,mon,6290657,639686,5650971
2010-12-22,23,mon,2556336,9079761,-6523425
2010-12-22,0,data,2630569,8189474,-5558905
2010-12-22,1,data,8831244,6736039,2095205
2010-12-22,2,data,5165907,4800712,365195
2010-12-22,3,data,2282840,5598564,-3315724
2010-12-22,4,data,5937835,9892873,-3955038
2010-12-22,5,data,3047549,9259611,-6212062
2010-12-22,6,data,7714191,1186507,6527684
2010-12-22,7,data,8249626,2560700,5688926
2010-12-22,8,data,683235,4511333,-3828098
2010-12-22,9,data,3153611,8258257,-5104646
2010-12-22,10,data,4829768,1948256,2881512
2010-12-22,11,data,7082416,5809737,1272679
2010-12-22,12,data,155006,8227800,-8072794
2010-12-22,13,data,8253757,950808,7302949
2010-12-22,14,data,9363057,3690139,5672918
2010-12-22,15,data,4215200,498408,3716792
2010-12-22,16,data,4297583,5113621,-816038
2010-12-22,17,data,4892677,2652927,2239750
2010-12-22,18,data,5039948,1458168,3581780
2010-12-22,19,data,1099956,1797462,-697506
2010-12-22,20,data,1803945,7608487,-5804542
2010-12-22,21,data,1228307,6998576,-5770269
2010-12-22,22,data,957100,289191,667909
2010-12-22,23,data,1725082,2128968,-403886
2010-12-22,0,voice,109349,6286393,-6177044
2010-12-22,1,voice,8831393,6927667,1903726
2010-12-22,2,voice,5510751,4844946,665805
2010-12-22,3,voice,726354,4908186,-4181832
2010-12-22,4,voice,4069496,1166603,2902893
2010-12-22,5,voice,1891154,5655078,-3763924
2010-12-22,6,voice,142588,5872233,-5729645
2010-12-22,7,voice,4162620,9878049,-5715429
2010-12-22,8,voice,4969863,7217716,-2247853
2010-12-22,9,voice,4019675,530339,3489336
2010-12-22,10,voice,4045889,6355822,-2309933
2010-12-22,11,voice,9918637,7345621,2573016
2010-12-22,12,voice,6688317,2018828,4669489
2010-12-22,13,voice,1124781,5621034,-4496253
2010-12-22,14,voice,45805,9009244,-8963439
2010-12-22,15,voice,6731456,4501935,2229521
2010-12-22,16,voice,1141255,7768375,-6627120
2010-12-22,17,voice,274454,4874377,-4599923
2010-12-22,18,voice,9674185,6637076,3037109
2010-12-22,19,voice,8938257,1238572,7699685
2010-12-22,20,voice,9923708,4731021,5192687
2010-12-22,21,voice,8687540,4412844,4274696
2010-12-22,22,voice,8700645,6426017,2274628
2010-12-22,23,voice,72250,9258165,-9185915
2010-12-22,0,sms,2143458,7976717,-5833259
2010-12-22,1,sms,1290825,8043397,-6752572
2010-12-22,2,sms,1893238,2351646,-458408
2010-12-22,3,sms,3408983,8696214,-5287231
2010-12-22,4,sms,824633,2941851,-2117218
2010-12-22,5,sms,8116864,8801620,-684756
2010-12-22,6,sms,9353550,43137,9310413
2010-12-22,7,sms,8313640,1884237,6429403
2010-12-22,8,sms,3157011,4391933,-1234922
2010-12-22,9,sms,5518748,9854034,-4335286
2010-12-22,10,sms,2042595,6696643,-4654048
2010-12-22,11,sms,4789402,6916288,-2126886
2010-12-22,12,sms,9340156,8242811,1097345
2010-12-22,13,sms,6237501,902363,5335138
2010-12-22,14,sms,5565310,2077130,3488180
2010-12-22,15,sms,3185962,1917203,1268759
2010-12-22,16,sms,7531084,4050014,3481070
2010-12-22,17,sms,6957939,7853268,-895329
2010-12-22,18,sms,540179,4096393,-3556214
2010-12-22,19,sms,17547,8779426,-8761879
2010-12-22,20,sms,8462498,701337,7761161
2010-12-22,21,sms,7486130,5874576,1611554
2010-12-22,22,sms,427015,5772978,-5345963
2010-12-22,23,sms,9708994,5488351,4220643
2010-12-22,0,clr,29954,5202852,-5172898
2010-12-22,1,clr,9382341,4548364,4833977
2010-12-22,2,clr,5543679,4733862,809817
2010-12-22,3,clr,8549810,3746514,4803296
2010-12-22,4,clr,1189032,6155511,-4966479
2010-12-22,5,clr,1233435,4878621,-3645186
2010-12-22,6,clr,6766056,3775319,2990737
2010-12-22,7,clr,2638669,2608260,30409
2010-12-22,8,clr,6798272,4856649,1941623
2010-12-22,9,clr,911074,6180997,-5269923
2010-12-22,10,clr,6737544,2473756,4263788
2010-12-22,11,clr,2841694,3542819,-701125
2010-12-22,12,clr,2996508,2121136,875372
2010-12-22,13,clr,1046620,1901834,-855214
2010-12-22,14,clr,9425340,949523,8475817
2010-12-22,15,clr,7994143,2889479,5104664
2010-12-22,16,clr,9505506,3089005,6416501
2010-12-22,17,clr,6720197,4231929,2488268
2010-12-22,18,clr,2508808,3118873,-610065
2010-12-22,19,clr,9521108,1098336,8422772
2010-12-22,20,clr,9313482,3162827,6150655
2010-12-22,21,clr,6786054,2528454,4257600
2010-12-22,22,clr,2562012,1437101,1124911
2010-12-22,23,clr,9073620,9657013,-583393
2010-12-23,0,com,7905192,1393234,6511958
2010-12-23,1,com,9159015,6437790,2721225
2010-12-23,2,com,3253926,5877403,-2623477
2010-12-23,3,com,6001955,3016218,2985737
2010-12-23,4,com,2838155,1672974,1165181
2010-12-23,5,com,3764791,2808159,956632
2010-12-23,6,com,9494321,7889299,1605022
2010-12-23,7,com,2729089,4021161,-1292072
2010-12-23,8,com,3314980,7923978,-4608998
2010-12-23,9,com,4827259,4705170,122089
2010-12-23,10,com,9123895,4848922,4274973
2010-12-23,11,com,9074960,9030337,44623
2010-12-23,12,com,7970546,6099556,1870990
2010-12-23,13,com,1610383,9830834,-8220451
2010-12-23,14,com,9546277,6294569,3251708
2010-12-23,15,com,4253980,7159913,-2905933
2010-12-23,16,com,882649,5946352,-5063703
2010-12-23,17,com,7415631,9723648,-2308017
2010-12-23,18,com,2955132,2211681,743451
2010-12-23,19,com,3563866,1993625,1570241
2010-12-23,20,com,6804861,5819781,985080
2010-12-23,21,com,5988996,4562137,1426859
2010-12-23,22,com,961707,9805807,-8844100
2010-12-23,23,com,7908951,6266151,1642800
2010-12-23,0,vou,1364996,5719177,-4354181
2010-12-23,1,vou,9884058,3362648,6521410
2010-12-23,2,vou,3663171,8881996,-5218825
2010-12-23,3,vou,9427508,6028139,3399369
2010-12-23,4,vou,9533401,2532145,7001256
2010-12-23,5,vou,130085,7575375,-7445290
2010-12-23,6,vou,5598148,7899036,-2300888
2010-12-23,7,vou,5535143,6430300,-895157
2010-12-23,8,vou,408893,9481271,-9072378
2010-12-23,9,vou,7195175,1054134,6141041
2010-12-23,10,vou,8361443,9362996,-1001553
2010-12-23,11,vou,8745737,88128,8657609
2010-12-23,12,vou,8133775,5327950,2805825
2010-12-23,13,vou,3739244,1305023,2434221
2010-12-23,14,vou,8941924,7490374,1451550
2010-12-23,15,vou,4441414,924369,3517045
2010-12-23,16,vou,4257003,1324341,2932662
2010-12-23,17,vou,9959100,354074,9605026
2010-12-23,18,vou,3564447,5930488,-2366041
2010-12-23,19,vou,85995,3177504,-3091509
2010-12-23,20,vou,4143084,5551707,-1408623
2010-12-23,21,vou,7781954,5221642,2560312
2010-12-23,22,vou,2293622,8962484,-6668862
2010-12-23,23,vou,3189930,3390750,-200820
2010-12-23,0,cm,5045709,6374923,-1329214
2010-12-23,1,cm,5628202,5011725,616477
2010-12-23,2,cm,7377789,1371069,6006720
2010-12-23,3,cm,3053633,1336,3052297
2010-12-23,4,cm,5727083,7400888,-1673805
2010-12-23,5,cm,785636,8295629,-7509993
2010-12-23,6,cm,8267955,5302392,2965563
2010-12-23,7,cm,1300944,283023,1017921
2010-12-23,8,cm,7430045,888066,6541979
2010-12-23,9,cm,6913119,5190306,1722813
2010-12-23,10,cm,8670693,7844719,825974
2010-12-23,11,cm,1160862,774326,386536
2010-12-23,12,cm,9791196,4223616,5567580
2010-12-23,13,cm,9573924,9306952,266972
2010-12-23,14,cm,7160612,1536631,5623981
2010-12-23,15,cm,93113,6130037,-6036924
2010-12-23,16,cm,8234503,8437265,-202762
2010-12-23,17,cm,8756535,9644324,-887789
2010-12-23,18,cm,2661028,7471135,-4810107
2010-12-23,19,cm,6984697,2668306,4316391
2010-12-23,20,cm,2442622,1325059,1117563
2010-12-23,21,cm,6972881,2912606,4060275
2010-12-23,22,cm,1729427,708090,1021337
2010-12-23,23,cm,5898808,4772367,1126441
2010-12-23,0,adj,7702888,4207740,3495148
2010-12-23,1,adj,5114460,6392917,-1278457
2010-12-23,2,adj,8618436,6314298,2304138
2010-12-23,3,adj,3206387,6331407,-3125020
2010-12-23,4,adj,9839090,8420328,1418762
2010-12-23,5,adj,8403662,2901073,5502589
2010-12-23,6,adj,5139479,3852602,1286877
2010-12-23,7,adj,8703141,4168440,4534701
2010-12-23,8,adj,4916930,7964707,-3047777
2010-12-23,9,adj,2048867,4329673,-2280806
2010-12-23,10,adj,1265151,2012753,-747602
2010-12-23,11,adj,9855913,6801897,3054016
2010-12-23,12,adj,34830,8840195,-8805365
2010-12-23,13,adj,3457159,7357198,-3900039
2010-12-23,14,adj,517853,6030717,-5512864
2010-12-23,15,adj,462932,2160878,-1697946
2010-12-23,16,adj,5532605,1594906,3937699
2010-12-23,17,adj,6857912,9575522,-2717610
2010-12-23,18,adj,6802471,7834370,-1031899
2010-12-23,19,adj,1108799,6354171,-5245372
2010-12-23,20,adj,3502718,9560357,-6057639
2010-12-23,21,adj,2301919,7789508,-5487589
2010-12-23,22,adj,7550525,9255668,-1705143
2010-12-23,23,adj,1774526,6397303,-4622777
2010-12-23,0,first,340449,5051366,-4710917
2010-12-23,1,first,1087389,9918470,-8831081
2010-12-23,2,first,7684085,967844,6716241
2010-12-23,3,first,5476182,5618436,-142254
2010-12-23,4,first,4950718,596605,4354113
2010-12-23,5,first,4752995,8441974,-3688979
2010-12-23,6,first,5930748,4735388,1195360
2010-12-23,7,first,883403,1442525,-559122
2010-12-23,8,first,3450745,3218051,232694
2010-12-23,9,first,7139330,1974776,5164554
2010-12-23,10,first,2698450,7017704,-4319254
2010-12-23,11,first,452285,7041178,-6588893
2010-12-23,12,first,2125149,1440800,684349
2010-12-23,13,first,1629013,1887580,-258567
2010-12-23,14,first,4187325,5643721,-1456396
2010-12-23,15,first,2292688,7509588,-5216900
2010-12-23,16,first,1142642,6705870,-5563228
2010-12-23,17,first,9513541,8743782,769759
2010-12-23,18,first,3528770,9621829,-6093059
2010-12-23,19,first,3462184,901167,2561017
2010-12-23,20,first,9769254,7171368,2597886
2010-12-23,21,first,5359712,2969452,2390260
2010-12-23,22,first,2262153,6432741,-4170588
2010-12-23,23,first,98980,1711138,-1612158
2010-12-23,0,mon,6055334,1775090,4280244
2010-12-23,1,mon,9249916,3050979,6198937
2010-12-23,2,mon,9699611,5682683,4016928
2010-12-23,3,mon,4183659,3157233,1026426
2010-12-23,4,mon,3859481,2942748,916733
2010-12-23,5,mon,525807,8482231,-7956424
2010-12-23,6,mon,2203213,1798305,404908
2010-12-23,7,mon,9930162,5351641,4578521
2010-12-23,8,mon,1521628,3223230,-1701602
2010-12-23,9,mon,3734714,2556066,1178648
2010-12-23,10,mon,4580612,1794229,2786383
2010-12-23,11,mon,1202971,1635768,-432797
2010-12-23,12,mon,4654332,3793174,861158
2010-12-23,13,mon,3984902,1404418,2580484
2010-12-23,14,mon,131669,5222731,-5091062
2010-12-23,15,mon,2141433,7570555,-5429122
2010-12-23,16,mon,7915184,4312061,3603123
2010-12-23,17,mon,2361251,1772440,588811
2010-12-23,18,mon,5438497,659555,4778942
2010-12-23,19,mon,9435281,7183059,2252222
2010-12-23,20,mon,4015283,3810244,205039
2010-12-23,21,mon,8603443,8400546,202897
2010-12-23,22,mon,7887635,3373291,4514344
2010-12-23,23,mon,7239751,7741255,-501504
2010-12-23,0,data,2188798,1748273,440525
2010-12-23,1,data,1405265,4226852,-2821587
2010-12-23,2,data,3938708,4349897,-411189
2010-12-23,3,data,1062709,9323560,-8260851
2010-12-23,4,data,539711,1665143,-1125432
2010-12-23,5,data,8433603,5787791,2645812
2010-12-23,6,data,5628282,6838563,-1210281
2010-12-23,7,data,545614,6873944,-6328330
2010-12-23,8,data,3532079,2785808,746271
2010-12-23,9,data,3212137,4646946,-1434809
2010-12-23,10,data,7907577,2544418,5363159
2010-12-23,11,data,4706624,3669072,1037552
2010-12-23,12,data,8313305,6568276,1745029
2010-12-23,13,data,5363811,2172426,3191385
2010-12-23,14,data,7182904,4447803,2735101
2010-12-23,15,data,9319093,131656,9187437
2010-12-23,16,data,644714,9805929,-9161215
2010-12-23,17,data,8881019,1690306,7190713
2010-12-23,18,data,8312740,4367639,3945101
2010-12-23,19,data,8973081,1265084,7707997
2010-12-23,20,data,6663886,9423841,-2759955
2010-12-23,21,data,2788889,2963281,-174392
2010-12-23,22,data,2717307,3523363,-806056
2010-12-23,23,data,5978634,1430562,4548072
2010-12-23,0,voice,6861152,3179717,3681435
2010-12-23,1,voice,3781137,8016505,-4235368
2010-12-23,2,voice,1520527,8164513,-6643986
2010-12-23,3,voice,4215131,7949847,-3734716
2010-12-23,4,voice,7874157,6643539,1230618
2010-12-23,5,voice,1890786,8822772,-6931986
2010-12-23,6,voice,6743979,9634268,-2890289
2010-12-23,7,voice,2651125,6366991,-3715866
2010-12-23,8,voice,4632358,3481763,1150595
2010-12-23,9,voice,1278811,4960002,-3681191
2010-12-23,10,voice,5924085,1071819,4852266
2010-12-23,11,voice,2019389,4728274,-2708885
2010-12-23,12,voice,4874185,2638372,2235813
2010-12-23,13,voice,5866172,6853743,-987571
2010-12-23,14,voice,491123,4939585,-4448462
2010-12-23,15,voice,5519580,7025731,-1506151
2010-12-23,16,voice,3080110,1073184,2006926
2010-12-23,17,voice,8945568,2918154,6027414
2010-12-23,18,voice,8476629,7389796,1086833
2010-12-23,19,voice,7674069,4642863,3031206
2010-12-23,20,voice,4372333,9245957,-4873624
2010-12-23,21,voice,4436890,874872,3562018
2010-12-23,22,voice,398717,2774373,-2375656
2010-12-23,23,voice,8083883,4171947,3911936
2010-12-23,0,sms,509992,2160022,-1650030
2010-12-23,1,sms,745618,9531398,-8785780
2010-12-23,2,sms,8854710,7134381,1720329
2010-12-23,3,sms,8320178,4943271,3376907
2010-12-23,4,sms,3605635,2681860,923775
2010-12-23,5,sms,7640212,7297737,342475
2010-12-23,6,sms,4704481,8980307,-4275826
2010-12-23,7,sms,9622302,7633706,1988596
2010-12-23,8,sms,8518166,2443003,6075163
2010-12-23,9,sms,8578876,2254290,6324586
2010-12-23,10,sms,5051973,4604265,447708
2010-12-23,11,sms,2458789,7333430,-4874641
2010-12-23,12,sms,7989698,6291377,1698321
2010-12-23,13,sms,4303791,713622,3590169
2010-12-23,14,sms,6036998,7486907,-1449909
2010-12-23,15,sms,5124061,4025410,1098651
2010-12-23,16,sms,6276280,6195349,80931
2010-12-23,17,sms,2187897,7369174,-5181277
2010-12-23,18,sms,3308655,8637635,-5328980
2010-12-23,19,sms,9730962,7196122,2534840
2010-12-23,20,sms,2500894,9025194,-6524300
2010-12-23,21,sms,1321139,4590059,-3268920
2010-12-23,22,sms,7195811,945725,6250086
2010-12-23,23,sms,8833237,8557556,275681
2010-12-23,0,clr,9756736,3219744,6536992
2010-12-23,1,clr,4749391,6805476,-2056085
2010-12-23,2,clr,514030,7036069,-6522039
2010-12-23,3,clr,6906541,2812322,4094219
2010-12-23,4,clr,6810973,766974,6043999
2010-12-23,5,clr,3078393,6942627,-3864234
2010-12-23,6,clr,3752511,979279,2773232
2010-12-23,7,clr,757145,4397905,-3640760
2010-12-23,8,clr,8193094,5334158,2858936
2010-12-23,9,clr,6700828,2577959,4122869
2010-12-23,10,clr,555065,3775767,-3220702
2010-12-23,11,clr,729622,7779745,-7050123
2010-12-23,12,clr,4880491,9301455,-4420964
2010-12-23,13,clr,3661401,8143611,-4482210
2010-12-23,14,clr,979645,1795555,-815910
2010-12-23,15,clr,6990811,2152702,4838109
2010-12-23,16,clr,7194707,1102738,6091969
2010-12-23,17,clr,3605798,944761,2661037
2010-12-23,18,clr,261028,6103412,-5842384
2010-12-23,19,clr,3842302,1890162,1952140
2010-12-23,20,clr,58862,9171948,-9113086
2010-12-23,21,clr,2984122,5734697,-2750575
2010-12-23,22,clr,2710838,3181258,-470420
2010-12-23,23,clr,6957713,5677021,1280692
2010-12-24,0,com,1491552,1859409,-367857
2010-12-24,1,com,4517507,9575051,-5057544
2010-12-24,2,com,1845187,8033131,-6187944
2010-12-24,3,com,1627656,342374,1285282
2010-12-24,4,com,8203676,8408959,-205283
2010-12-24,5,com,8286656,3001801,5284855
2010-12-24,6,com,6033412,556760,5476652
2010-12-24,7,com,6103865,9281828,-3177963
2010-12-24,8,com,4707234,7960726,-3253492
2010-12-24,9,com,3435376,2117629,1317747
2010-12-24,10,com,1611889,4858240,-3246351
2010-12-24,11,com,6605687,2885630,3720057
2010-12-24,12,com,4238768,1463648,2775120
2010-12-24,13,com,8046182,5238377,2807805
2010-12-24,14,com,5944884,334754,5610130
2010-12-24,15,com,1008499,7940738,-6932239
2010-12-24,16,com,3445883,7244516,-3798633
2010-12-24,17,com,8711528,3097668,5613860
2010-12-24,18,com,9110565,1815925,7294640
2010-12-24,19,com,3568899,1579566,1989333
2010-12-24,20,com,7593931,7202016,391915
2010-12-24,21,com,6311927,6830934,-519007
2010-12-24,22,com,492940,9314045,-8821105
2010-12-24,23,com,220407,8275833,-8055426
2010-12-24,0,vou,8176615,6060756,2115859
2010-12-24,1,vou,4999449,5259886,-260437
2010-12-24,2,vou,3215763,5351155,-2135392
2010-12-24,3,vou,4392366,1417154,2975212
2010-12-24,4,vou,9264638,4838345,4426293
2010-12-24,5,vou,4993244,7254424,-2261180
2010-12-24,6,vou,9492512,6531504,2961008
2010-12-24,7,vou,3410518,9971869,-6561351
2010-12-24,8,vou,7582079,9758170,-2176091
2010-12-24,9,vou,5504510,1713245,3791265
2010-12-24,10,vou,2107188,7725217,-5618029
2010-12-24,11,vou,9345790,1617094,7728696
2010-12-24,12,vou,8782091,7346912,1435179
2010-12-24,13,vou,3347008,3974436,-627428
2010-12-24,14,vou,31243,1821808,-1790565
2010-12-24,15,vou,7581436,7303948,277488
2010-12-24,16,vou,9597710,8172673,1425037
2010-12-24,17,vou,359205,4275490,-3916285
2010-12-24,18,vou,2720819,2141457,579362
2010-12-24,19,vou,7683699,6197929,1485770
2010-12-24,20,vou,2567245,5881954,-3314709
2010-12-24,21,vou,1606617,1640861,-34244
2010-12-24,22,vou,1436953,7289093,-5852140
2010-12-24,23,vou,3005713,8467731,-5462018
2010-12-24,0,cm,1806871,1229609,577262
2010-12-24,1,cm,8804919,4840669,3964250
2010-12-24,2,cm,6067374,2345555,3721819
2010-12-24,3,cm,250471,6153653,-5903182
2010-12-24,4,cm,8204942,7336808,868134
2010-12-24,5,cm,4987153,1589143,3398010
2010-12-24,6,cm,1687616,9488254,-7800638
2010-12-24,7,cm,1282010,9593923,-8311913
2010-12-24,8,cm,7287644,2478242,4809402
2010-12-24,9,cm,2075055,4452745,-2377690
2010-12-24,10,cm,317317,1096092,-778775
2010-12-24,11,cm,3596809,6328267,-2731458
2010-12-24,12,cm,7582455,3537891,4044564
2010-12-24,13,cm,7105135,2628491,4476644
2010-12-24,14,cm,4697322,3470302,1227020
2010-12-24,15,cm,4175876,1410435,2765441
2010-12-24,16,cm,6920094,3901229,3018865
2010-12-24,17,cm,4234495,4921915,-687420
2010-12-24,18,cm,9331077,6965553,2365524
2010-12-24,19,cm,498828,3029735,-2530907
2010-12-24,20,cm,6820457,5266678,1553779
2010-12-24,21,cm,748015,6914229,-6166214
2010-12-24,22,cm,6044598,6371285,-326687
2010-12-24,23,cm,3007777,1182812,1824965
2010-12-24,0,adj,3291267,8317893,-5026626
2010-12-24,1,adj,3549816,1783135,1766681
2010-12-24,2,adj,7094747,746017,6348730
2010-12-24,3,adj,2451516,9004961,-6553445
2010-12-24,4,adj,5597030,1405743,4191287
2010-12-24,5,adj,8329089,2088361,6240728
2010-12-24,6,adj,8930573,1959780,6970793
2010-12-24,7,adj,9622925,965598,8657327
2010-12-24,8,adj,2006142,6315976,-4309834
2010-12-24,9,adj,2376703,2924698,-547995
2010-12-24,10,adj,1196819,2003124,-806305
2010-12-24,11,adj,4265647,5241494,-975847
2010-12-24,12,adj,9728849,7566540,2162309
2010-12-24,13,adj,8521095,3431139,5089956
2010-12-24,14,adj,3392150,3786439,-394289
2010-12-24,15,adj,4019134,658727,3360407
2010-12-24,16,adj,7347259,1569848,5777411
2010-12-24,17,adj,549034,1697473,-1148439
2010-12-24,18,adj,3795715,926382,2869333
2010-12-24,19,adj,8330549,8845010,-514461
2010-12-24,20,adj,1053694,252613,801081
2010-12-24,21,adj,2484518,4498979,-2014461
2010-12-24,22,adj,1432320,2899731,-1467411
2010-12-24,23,adj,6515307,8547695,-2032388
2010-12-24,0,first,3464529,5347170,-1882641
2010-12-24,1,first,7472125,4797328,2674797
2010-12-24,2,first,8680994,9737532,-1056538
2010-12-24,3,first,6054460,4649467,1404993
2010-12-24,4,first,2647417,7072266,-4424849
2010-12-24,5,first,8204506,4601303,3603203
2010-12-24,6,first,1593296,8078786,-6485490
2010-12-24,7,first,3068052,5906204,-2838152
2010-12-24,8,first,596528,1663034,-1066506
2010-12-24,9,first,5618038,9729309,-4111271
2010-12-24,10,first,3186801,6890963,-3704162
2010-12-24,11,first,6768896,9841460,-3072564
2010-12-24,12,first,6065389,9220150,-3154761
2010-12-24,13,first,8106830,5114278,2992552
2010-12-24,14,first,2783828,5948346,-3164518
2010-12-24,15,first,9909335,8761904,1147431
2010-12-24,16,first,8966074,8007104,958970
2010-12-24,17,first,3601486,5185639,-1584153
2010-12-24,18,first,3038121,1768222,1269899
2010-12-24,19,first,2234182,6848806,-4614624
2010-12-24,20,first,5829552,6727438,-897886
2010-12-24,21,first,3548235,1721514,1826721
2010-12-24,22,first,4193497,7920632,-3727135
2010-12-24,23,first,9691753,1002645,8689108
2010-12-24,0,mon,4902197,9288286,-4386089
2010-12-24,1,mon,6044115,6505693,-461578
2010-12-24,2,mon,5515308,686620,4828688
2010-12-24,3,mon,8267654,3873705,4393949
2010-12-24,4,mon,610293,8628606,-8018313
2010-12-24,5,mon,4725260,2883268,1841992
2010-12-24,6,mon,7403481,6027266,1376215
2010-12-24,7,mon,6603630,3001097,3602533
2010-12-24,8,mon,7494295,9080480,-1586185
2010-12-24,9,mon,1801193,9581827,-7780634
2010-12-24,10,mon,8252101,684242,7567859
2010-12-24,11,mon,7558242,8941931,-1383689
2010-12-24,12,mon,9543137,7939398,1603739
2010-12-24,13,mon,7643129,8774435,-1131306
2010-12-24,14,mon,1420502,8556793,-7136291
2010-12-24,15,mon,3129668,808532,2321136
2010-12-24,16,mon,1292953,9740911,-8447958
2010-12-24,17,mon,5790273,9654987,-3864714
2010-12-24,18,mon,3625541,508475,3117066
2010-12-24,19,mon,3681101,1379509,2301592
2010-12-24,20,mon,7036049,9957817,-2921768
2010-12-24,21,mon,5493952,4359748,1134204
2010-12-24,22,mon,8418593,9051962,-633369
2010-12-24,23,mon,2052002,8652656,-6600654
2010-12-24,0,data,5244548,4037317,1207231
2010-12-24,1,data,5172618,4544029,628589
2010-12-24,2,data,6932019,9221228,-2289209
2010-12-24,3,data,7075546,3039469,4036077
2010-12-24,4,data,6011023,2971113,3039910
2010-12-24,5,data,3952535,7139313,-3186778
2010-12-24,6,data,2160001,7254880,-5094879
2010-12-24,7,data,258982,7907506,-7648524
2010-12-24,8,data,743566,1702899,-959333
2010-12-24,9,data,2670471,1748340,922131
2010-12-24,10,data,8286635,4866836,3419799
2010-12-24,11,data,398592,9432934,-9034342
2010-12-24,12,data,4889657,42933,4846724
2010-12-24,13,data,6177470,3335170,2842300
2010-12-24,14,data,3755433,6375363,-2619930
2010-12-24,15,data,9395048,4443834,4951214
2010-12-24,16,data,7349633,6256958,1092675
2010-12-24,17,data,8649925,7208888,1441037
2010-12-24,18,data,1064922,313470,751452
2010-12-24,19,data,2833482,2330357,503125
2010-12-24,20,data,4985337,2189160,2796177
2010-12-24,21,data,8688740,2805693,5883047
2010-12-24,22,data,281474,5560155,-5278681
2010-12-24,23,data,9463230,4872355,4590875
2010-12-24,0,voice,7265976,5069879,2196097
2010-12-24,1,voice,8425835,1266626,7159209
2010-12-24,2,voice,2138887,534891,1603996
2010-12-24,3,voice,7540271,6447116,1093155
2010-12-24,4,voice,6436320,7587256,-1150936
2010-12-24,5,voice,3146972,6469528,-3322556
2010-12-24,6,voice,9464816,540864,8923952
2010-12-24,7,voice,9369007,882021,8486986
2010-12-24,8,voice,8400862,7656718,744144
2010-12-24,9,voice,2223244,7256647,-5033403
2010-12-24,10,voice,6914034,1407870,5506164
2010-12-24,11,voice,6823331,5845484,977847
2010-12-24,12,voice,9512242,5482493,4029749
2010-12-24,13,voice,93582,8352093,-8258511
2010-12-24,14,voice,6020962,1746751,4274211
2010-12-24,15,voice,8135495,8643620,-508125
2010-12-24,16,voice,4208724,6127435,-1918711
2010-12-24,17,voice,1842218,9323985,-7481767
2010-12-24,18,voice,115452,1691459,-1576007
2010-12-24,19,voice,789702,6933453,-6143751
2010-12-24,20,voice,3977795,7849456,-3871661
2010-12-24,21,voice,4804705,8828773,-4024068
2010-12-24,22,voice,4619171,8998943,-4379772
2010-12-24,23,voice,6608617,689895,5918722
2010-12-24,0,sms,261759,6991835,-6730076
2010-12-24,1,sms,2669452,3770738,-1101286
2010-12-24,2,sms,9061614,4902250,4159364
2010-12-24,3,sms,8619507,7431400,1188107
2010-12-24,4,sms,2495099,4506902,-2011803
2010-12-24,5,sms,9365956,8179052,1186904
2010-12-24,6,sms,1867584,9880358,-8012774
2010-12-24,7,sms,2473887,1810222,663665
2010-12-24,8,sms,4681697,8851180,-4169483
2010-12-24,9,sms,3446673,8992178,-5545505
2010-12-24,10,sms,9523581,587598,8935983
2010-12-24,11,sms,7085338,4364605,2720733
2010-12-24,12,sms,8955741,9868188,-912447
2010-12-24,13,sms,7171773,2715319,4456454
2010-12-24,14,sms,2780020,4029981,-1249961
2010-12-24,15,sms,8771501,3621940,5149561
2010-12-24,16,sms,1020061,3391694,-2371633
2010-12-24,17,sms,7569843,4464956,3104887
2010-12-24,18,sms,85897,2271754,-2185857
2010-12-24,19,sms,7422782,3642208,3780574
2010-12-24,20,sms,6312189,6003251,308938
2010-12-24,21,sms,105534,8396660,-8291126
2010-12-24,22,sms,2859875,9609830,-6749955
2010-12-24,23,sms,9087462,5193273,3894189
2010-12-24,0,clr,856918,737728,119190
2010-12-24,1,clr,5409321,8115187,-2705866
2010-12-24,2,clr,7576585,6419851,1156734
2010-12-24,3,clr,2966260,7623982,-4657722
2010-12-24,4,clr,8014125,3329911,4684214
2010-12-24,5,clr,5101211,5122069,-20858
2010-12-24,6,clr,4439604,1098228,3341376
2010-12-24,7,clr,9574479,6777258,2797221
2010-12-24,8,clr,3809928,7003738,-3193810
2010-12-24,9,clr,6625586,6418488,207098
2010-12-24,10,clr,7196613,5528037,1668576
2010-12-24,11,clr,1447774,2316384,-868610
2010-12-24,12,clr,5057741,8927476,-3869735
2010-12-24,13,clr,8792139,9453282,-661143
2010-12-24,14,clr,932557,7130529,-6197972
2010-12-24,15,clr,3536689,7056237,-3519548
2010-12-24,16,clr,1842841,8040194,-6197353
2010-12-24,17,clr,667152,4232947,-3565795
2010-12-24,18,clr,8415247,9898518,-1483271
2010-12-24,19,clr,6442386,4102061,2340325
2010-12-24,20,clr,6010147,9860131,-3849984
2010-12-24,21,clr,8048330,2954222,5094108
2010-12-24,22,clr,9402945,7741633,1661312
2010-12-24,23,clr,9632523,3478619,6153904
2010-12-25,0,com,1894326,4132767,-2238441
2010-12-25,1,com,5746014,8133555,-2387541
2010-12-25,2,com,4356503,3451896,904607
2010-12-25,3,com,8180983,3943584,4237399
2010-12-25,4,com,6826459,281875,6544584
2010-12-25,5,com,7880872,2143183,5737689
2010-12-25,6,com,4837260,2567036,2270224
2010-12-25,7,com,8306192,5346730,2959462
2010-12-25,8,com,7802855,9432496,-1629641
2010-12-25,9,com,3814942,2542957,1271985
2010-12-25,10,com,8319815,7396683,923132
2010-12-25,11,com,1965851,1579176,386675
2010-12-25,12,com,3483137,4390475,-907338
2010-12-25,13,com,7393205,1238979,6154226
2010-12-25,14,com,3960838,9100451,-5139613
2010-12-25,15,com,2155361,7720214,-5564853
2010-12-25,16,com,7536202,792774,6743428
2010-12-25,17,com,4298091,3704556,593535
2010-12-25,18,com,4715237,6251690,-1536453
2010-12-25,19,com,4597355,4194781,402574
2010-12-25,20,com,3387008,5486250,-2099242
2010-12-25,21,com,3496134,9875463,-6379329
2010-12-25,22,com,6738879,5022004,1716875
2010-12-25,23,com,8088864,6246049,1842815
2010-12-25,0,vou,373327,4791803,-4418476
2010-12-25,1,vou,6254434,7953335,-1698901
2010-12-25,2,vou,7763831,421147,7342684
2010-12-25,3,vou,7998418,3238252,4760166
2010-12-25,4,vou,361106,1225820,-864714
2010-12-25,5,vou,6774280,5372901,1401379
2010-12-25,6,vou,4550040,7755848,-3205808
2010-12-25,7,vou,5131268,3072974,2058294
2010-12-25,8,vou,2808019,695230,2112789
2010-12-25,9,vou,8134455,2064997,6069458
2010-12-25,10,vou,6450665,7847236,-1396571
2010-12-25,11,vou,6907867,8014227,-1106360
2010-12-25,12,vou,6840442,3639508,3200934
2010-12-25,13,vou,6893531,5919405,974126
2010-12-25,14,vou,7438611,5740068,1698543
2010-12-25,15,vou,8679274,1411547,7267727
2010-12-25,16,vou,1061123,9564915,-8503792
2010-12-25,17,vou,9441606,9039027,402579
2010-12-25,18,vou,1436093,5143860,-3707767
2010-12-25,19,vou,5883004,5584830,298174
2010-12-25,20,vou,106653,2767351,-2660698
2010-12-25,21,vou,9546536,4386875,5159661
2010-12-25,22,vou,8628463,7551210,1077253
2010-12-25,23,vou,7311041,5221388,2089653
2010-12-25,0,cm,2423780,959120,1464660
2010-12-25,1,cm,3565252,235183,3330069
2010-12-25,2,cm,3615060,5658363,-2043303
2010-12-25,3,cm,9594920,4955014,4639906
2010-12-25,4,cm,1492507,9751873,-8259366
2010-12-25,5,cm,5579933,2695978,2883955
2010-12-25,6,cm,8580066,762490,7817576
2010-12-25,7,cm,9473828,5341438,4132390
2010-12-25,8,cm,3980114,7119204,-3139090
2010-12-25,9,cm,8952905,4564252,4388653
2010-12-25,10,cm,7780888,8717103,-936215
2010-12-25,11,cm,9297235,5231132,4066103
2010-12-25,12,cm,1824610,4972417,-3147807
2010-12-25,13,cm,8663489,2087067,6576422
2010-12-25,14,cm,2846351,2114893,731458
2010-12-25,15,cm,8098867,5452594,2646273
2010-12-25,16,cm,8198544,1660620,6537924
2010-12-25,17,cm,9524276,9518067,6209
2010-12-25,18,cm,4114470,7368122,-3253652
2010-12-25,19,cm,6234297,503776,5730521
2010-12-25,20,cm,1868546,254222,1614324
2010-12-25,21,cm,9390794,6033949,3356845
2010-12-25,22,cm,7171438,3942147,3229291
2010-12-25,23,cm,8435635,7849715,585920
2010-12-25,0,adj,455000,2681083,-2226083
2010-12-25,1,adj,7997292,3019812,4977480
2010-12-25,2,adj,974608,9719461,-8744853
2010-12-25,3,adj,8358564,6963668,1394896
2010-12-25,4,adj,1734772,6129295,-4394523
2010-12-25,5,adj,6795089,1470348,5324741
2010-12-25,6,adj,1752082,3288016,-1535934
2010-12-25,7,adj,7058770,9392199,-2333429
2010-12-25,8,adj,8516479,2569286,5947193
2010-12-25,9,adj,3766931,497459,3269472
2010-12-25,10,adj,1784598,4453767,-2669169
2010-12-25,11,adj,5353707,2705385,2648322
2010-12-25,12,adj,3389120,8625075,-5235955
2010-12-25,13,adj,313066,840891,-527825
2010-12-25,14,adj,1210934,37852,1173082
2010-12-25,15,adj,2186029,4573778,-2387749
2010-12-25,16,adj,6309689,9937539,-3627850
2010-12-25,17,adj,7506414,7997668,-491254
2010-12-25,18,adj,7198488,2438726,4759762
2010-12-25,19,adj,8672429,5077422,3595007
2010-12-25,20,adj,8688380,1316860,7371520
2010-12-25,21,adj,7049132,4730046,2319086
2010-12-25,22,adj,1325909,945474,380435
2010-12-25,23,adj,4752054,7322763,-2570709
2010-12-25,0,first,7087406,5233605,1853801
2010-12-25,1,first,2049557,5117381,-3067824
2010-12-25,2,first,1327039,6369947,-5042908
2010-12-25,3,first,3000873,6213927,-3213054
2010-12-25,4,first,9951040,4716366,5234674
2010-12-25,5,first,9635874,3061324,6574550
2010-12-25,6,first,2200537,5267018,-3066481
2010-12-25,7,first,140888,1335605,-1194717
2010-12-25,8,first,8442473,9141021,-698548
2010-12-25,9,first,609935,1280765,-670830
2010-12-25,10,first,3822620,2825807,996813
2010-12-25,11,first,5748470,5084030,664440
2010-12-25,12,first,538845,7532603,-6993758
2010-12-25,13,first,9993872,4535362,5458510
2010-12-25,14,first,7373853,9090849,-1716996
2010-12-25,15,first,1131946,9519373,-8387427
2010-12-25,16,first,8157427,5672688,2484739
2010-12-25,17,first,9407607,8146411,1261196
2010-12-25,18,first,6659440,3069876,3589564
2010-12-25,19,first,5504053,2792847,2711206
2010-12-25,20,first,9894386,7761269,2133117
2010-12-25,21,first,3886347,8805980,-4919633
2010-12-25,22,first,7035765,2124301,4911464
2010-12-25,23,first,7158087,2542246,4615841
2010-12-25,0,mon,1124056,786170,337886
2010-12-25,1,mon,5774701,5710573,64128
2010-12-25,2,mon,7108584,4971645,2136939
2010-12-25,3,mon,1163013,8884194,-7721181
2010-12-25,4,mon,8653489,6435479,2218010
2010-12-25,5,mon,3187474,2053873,1133601
2010-12-25,6,mon,4141403,2140427,2000976
2010-12-25,7,mon,4529523,3309385,1220138
2010-12-25,8,mon,2574191,7694722,-5120531
2010-12-25,9,mon,8632795,7585821,1046974
2010-12-25,10,mon,7771556,3180523,4591033
2010-12-25,11,mon,7284759,7316823,-32064
2010-12-25,12,mon,3921759,1628976,2292783
2010-12-25,13,mon,4562968,1229486,3333482
2010-12-25,14,mon,3379043,8426919,-5047876
2010-12-25,15,mon,6467711,3924627,2543084
2010-12-25,16,mon,3141455,4535172,-1393717
2010-12-25,17,mon,258838,6316553,-6057715
2010-12-25,18,mon,638754,9070602,-8431848
2010-12-25,19,mon,5984501,9238215,-3253714
2010-12-25,20,mon,2123166,5049672,-2926506
2010-12-25,21,mon,8149657,849589,7300068
2010-12-25,22,mon,4791769,3671616,1120153
2010-12-25,23,mon,9240977,1961353,7279624
2010-12-25,0,data,2569261,8376168,-5806907
2010-12-25,1,data,8999094,3415034,5584060
2010-12-25,2,data,5827475,666093,5161382
2010-12-25,3,data,5730969,4607181,1123788
2010-12-25,4,data,7316426,7223193,93233
2010-12-25,5,data,4276294,3051169,1225125
2010-12-25,6,data,5629837,6826515,-1196678
2010-12-25,7,data,2854548,9452084,-6597536
2010-12-25,8,data,8353544,1590821,6762723
2010-12-25,9,data,2925122,8703928,-5778806
2010-12-25,10,data,4399799,5905255,-1505456
2010-12-25,11,data,4275309,3412781,862528
2010-12-25,12,data,1622198,7731785,-6109587
2010-12-25,13,data,7565633,1919017,5646616
2010-12-25,14,data,1001537,5623324,-4621787
2010-12-25,15,data,5988216,842094,5146122
2010-12-25,16,data,613764,8926627,-8312863
2010-12-25,17,data,5380254,285115,5095139
2010-12-25,18,data,1254857,5544267,-4289410
2010-12-25,19,data,2315600,9621479,-7305879
2010-12-25,20,data,6146996,6833190,-686194
2010-12-25,21,data,2705781,4363984,-1658203
2010-12-25,22,data,7178051,839526,6338525
2010-12-25,23,data,7884472,319636,7564836
2010-12-25,0,voice,2875191,8971186,-6095995
2010-12-25,1,voice,3421907,4876095,-1454188
2010-12-25,2,voice,4478491,8549801,-4071310
2010-12-25,3,voice,8383040,8541159,-158119
2010-12-25,4,voice,9747225,4721749,5025476
2010-12-25,5,voice,6078648,7246501,-1167853
2010-12-25,6,voice,6465961,1601429,4864532
2010-12-25,7,voice,5756447,1339268,4417179
2010-12-25,8,voice,7427349,5475720,1951629
2010-12-25,9,voice,5875913,8319407,-2443494
2010-12-25,10,voice,6881965,4243016,2638949
2010-12-25,11,voice,9941108,686273,9254835
2010-12-25,12,voice,2192040,2312462,-120422
2010-12-25,13,voice,2357419,5638000,-3280581
2010-12-25,14,voice,1862096,311390,1550706
2010-12-25,15,voice,5428020,4020824,1407196
2010-12-25,16,voice,2948604,2278946,669658
2010-12-25,17,voice,2284978,5895338,-3610360
2010-12-25,18,voice,9585522,8059141,1526381
2010-12-25,19,voice,3171936,3615118,-443182
2010-12-25,20,voice,4121456,305244,3816212
2010-12-25,21,voice,4234448,1267710,2966738
2010-12-25,22,voice,1020090,6760495,-5740405
2010-12-25,23,voice,1945609,5527500,-3581891
2010-12-25,0,sms,9282934,8998361,284573
2010-12-25,1,sms,5386571,4870262,516309
2010-12-25,2,sms,1717958,243461,1474497
2010-12-25,3,sms,9033707,5411766,3621941
2010-12-25,4,sms,748180,6093406,-5345226
2010-12-25,5,sms,9423359,6906587,2516772
2010-12-25,6,sms,5703340,2506770,3196570
2010-12-25,7,sms,6338006,6219798,118208
2010-12-25,8,sms,7770499,7019434,751065
2010-12-25,9,sms,1775619,5540912,-3765293
2010-12-25,10,sms,9897924,1596393,8301531
2010-12-25,11,sms,1746917,122743,1624174
2010-12-25,12,sms,7531986,5866388,1665598
2010-12-25,13,sms,8752502,8853316,-100814
2010-12-25,14,sms,8890839,6135235,2755604
2010-12-25,15,sms,3291972,1621846,1670126
2010-12-25,16,sms,6974726,545964,6428762
2010-12-25,17,sms,6387402,3007736,3379666
2010-12-25,18,sms,930065,8808768,-7878703
2010-12-25,19,sms,6817697,7096546,-278849
2010-12-25,20,sms,3062222,853563,2208659
2010-12-25,21,sms,905496,6894554,-5989058
2010-12-25,22,sms,6306739,3214648,3092091
2010-12-25,23,sms,324263,9194180,-8869917
2010-12-25,0,clr,7375733,2914835,4460898
2010-12-25,1,clr,174312,373067,-198755
2010-12-25,2,clr,1617846,2943298,-1325452
2010-12-25,3,clr,7664258,4972248,2692010
2010-12-25,4,clr,7788040,8820040,-1032000
2010-12-25,5,clr,7066271,8218532,-1152261
2010-12-25,6,clr,2884845,7105610,-4220765
2010-12-25,7,clr,2215166,4283374,-2068208
2010-12-25,8,clr,2700033,6828001,-4127968
2010-12-25,9,clr,3812975,9399981,-5587006
2010-12-25,10,clr,2255713,7134059,-4878346
2010-12-25,11,clr,9492532,6820072,2672460
2010-12-25,12,clr,2247496,9852742,-7605246
2010-12-25,13,clr,55841,3469515,-3413674
2010-12-25,14,clr,9929225,1636036,8293189
2010-12-25,15,clr,5264257,502045,4762212
2010-12-25,16,clr,6301268,8217162,-1915894
2010-12-25,17,clr,4827077,5555284,-728207
2010-12-25,18,clr,7395891,1977981,5417910
2010-12-25,19,clr,4494791,854758,3640033
2010-12-25,20,clr,3998096,9495710,-5497614
2010-12-25,21,clr,7338980,8151987,-813007
2010-12-25,22,clr,3462361,8209567,-4747206
2010-12-25,23,clr,2844794,3565741,-720947
2010-12-26,0,com,5541157,6238705,-697548
2010-12-26,1,com,9624199,1690417,7933782
2010-12-26,2,com,6161026,117996,6043030
2010-12-26,3,com,2948350,1282729,1665621
2010-12-26,4,com,8759728,319072,8440656
2010-12-26,5,com,5302705,3885882,1416823
2010-12-26,6,com,625467,9915597,-9290130
2010-12-26,7,com,7527754,7935964,-408210
2010-12-26,8,com,6312623,946442,5366181
2010-12-26,9,com,2243538,7083187,-4839649
2010-12-26,10,com,934599,8536568,-7601969
2010-12-26,11,com,2487858,8737907,-6250049
2010-12-26,12,com,9185371,8376370,809001
2010-12-26,13,com,8926658,2844603,6082055
2010-12-26,14,com,5788353,3588528,2199825
2010-12-26,15,com,3777030,7964018,-4186988
2010-12-26,16,com,9065636,829209,8236427
2010-12-26,17,com,1903263,119534,1783729
2010-12-26,18,com,9988526,1466561,8521965
2010-12-26,19,com,7375546,9037143,-1661597
2010-12-26,20,com,3510726,3752609,-241883
2010-12-26,21,com,7063601,5127137,1936464
2010-12-26,22,com,8489286,6222501,2266785
2010-12-26,23,com,3393738,447623,2946115
2010-12-26,0,vou,1282125,7881652,-6599527
2010-12-26,1,vou,6649182,2380035,4269147
2010-12-26,2,vou,2233379,8774678,-6541299
2010-12-26,3,vou,4241408,8855152,-4613744
2010-12-26,4,vou,7869767,6778014,1091753
2010-12-26,5,vou,8940882,990813,7950069
2010-12-26,6,vou,4635945,8904164,-4268219
2010-12-26,7,vou,5691863,802445,4889418
2010-12-26,8,vou,6909709,5181955,1727754
2010-12-26,9,vou,3465400,1458567,2006833
2010-12-26,10,vou,7453578,4072067,3381511
2010-12-26,11,vou,1814268,578406,1235862
2010-12-26,12,vou,6626993,5240159,1386834
2010-12-26,13,vou,7531633,3272025,4259608
2010-12-26,14,vou,3323500,1019763,2303737
2010-12-26,15,vou,8904484,1811853,7092631
2010-12-26,16,vou,5000657,8564353,-3563696
2010-12-26,17,vou,1110403,6640334,-5529931
2010-12-26,18,vou,2141660,2450132,-308472
2010-12-26,19,vou,7265963,7173447,92516
2010-12-26,20,vou,9384167,6330929,3053238
2010-12-26,21,vou,9531853,7160816,2371037
2010-12-26,22,vou,7361484,9710485,-2349001
2010-12-26,23,vou,11923,7376024,-7364101
2010-12-26,0,cm,4280637,4253690,26947
2010-12-26,1,cm,731811,4333763,-3601952
2010-12-26,2,cm,6831099,8060048,-1228949
2010-12-26,3,cm,5984511,4337219,1647292
2010-12-26,4,cm,3186792,4824783,-1637991
2010-12-26,5,cm,1068188,9819961,-8751773
2010-12-26,6,cm,6520487,3647521,2872966
2010-12-26,7,cm,7212225,5379879,1832346
2010-12-26,8,cm,1051825,6019954,-4968129
2010-12-26,9,cm,8118453,6136938,1981515
2010-12-26,10,cm,9639668,9728442,-88774
2010-12-26,11,cm,5193587,9059605,-3866018
2010-12-26,12,cm,1287212,9314681,-8027469
2010-12-26,13,cm,9172556,3091933,6080623
2010-12-26,14,cm,5726116,2477557,3248559
2010-12-26,15,cm,9963271,6333878,3629393
2010-12-26,16,cm,1843522,4906875,-3063353
2010-12-26,17,cm,25069,80548,-55479
2010-12-26,18,cm,5791688,3410394,2381294
2010-12-26,19,cm,6386561,2972899,3413662
2010-12-26,20,cm,5889821,5446201,443620
2010-12-26,21,cm,2395813,6643840,-4248027
2010-12-26,22,cm,523893,9778907,-9255014
2010-12-26,23,cm,447751,9142144,-8694393
2010-12-26,0,adj,9081158,231710,8849448
2010-12-26,1,adj,6393127,3223509,3169618
2010-12-26,2,adj,1905282,42569,1862713
2010-12-26,3,adj,9620387,2587549,7032838
2010-12-26,4,adj,6087018,9241028,-3154010
2010-12-26,5,adj,5989166,8574475,-2585309
2010-12-26,6,adj,5129611,7737272,-2607661
2010-12-26,7,adj,3786544,6531554,-2745010
2010-12-26,8,adj,6304033,1556631,4747402
2010-12-26,9,adj,9187472,9431747,-244275
2010-12-26,10,adj,5430771,5887070,-456299
2010-12-26,11,adj,3032651,7186476,-4153825
2010-12-26,12,adj,2958063,47140,2910923
2010-12-26,13,adj,194922,9156089,-8961167
2010-12-26,14,adj,901756,483173,418583
2010-12-26,15,adj,7186232,4028829,3157403
2010-12-26,16,adj,2954692,8244941,-5290249
2010-12-26,17,adj,649517,6659374,-6009857
2010-12-26,18,adj,2755245,6019493,-3264248
2010-12-26,19,adj,2206395,9508747,-7302352
2010-12-26,20,adj,7328572,502799,6825773
2010-12-26,21,adj,6660936,8491932,-1830996
2010-12-26,22,adj,3500095,7306694,-3806599
2010-12-26,23,adj,7644316,3188360,4455956
2010-12-26,0,first,9542573,7563663,1978910
2010-12-26,1,first,2961458,9624564,-6663106
2010-12-26,2,first,3999986,4611414,-611428
2010-12-26,3,first,236957,7354449,-7117492
2010-12-26,4,first,9851470,3623568,6227902
2010-12-26,5,first,8711310,2716066,5995244
2010-12-26,6,first,7738916,2960225,4778691
2010-12-26,7,first,8315594,8231478,84116
2010-12-26,8,first,5361540,8726157,-3364617
2010-12-26,9,first,3368166,438308,2929858
2010-12-26,10,first,5446036,9877639,-4431603
2010-12-26,11,first,6055480,6531341,-475861
2010-12-26,12,first,2594933,8412878,-5817945
2010-12-26,13,first,9902679,7073756,2828923
2010-12-26,14,first,5260597,681843,4578754
2010-12-26,15,first,2538650,7272799,-4734149
2010-12-26,16,first,2941679,1728260,1213419
2010-12-26,17,first,6212258,2496112,3716146
2010-12-26,18,first,7106879,6944937,161942
2010-12-26,19,first,360224,4153267,-3793043
2010-12-26,20,first,4846275,5142927,-296652
2010-12-26,21,first,3574155,7734339,-4160184
2010-12-26,22,first,9410188,6259630,3150558
2010-12-26,23,first,4360625,9736177,-5375552
2010-12-26,0,mon,7713147,2794732,4918415
2010-12-26,1,mon,159556,7391921,-7232365
2010-12-26,2,mon,8497983,925057,7572926
2010-12-26,3,mon,6841719,1990181,4851538
2010-12-26,4,mon,1572792,2330720,-757928
2010-12-26,5,mon,3806710,8378945,-4572235
2010-12-26,6,mon,6644944,9147464,-2502520
2010-12-26,7,mon,8171515,7954762,216753
2010-12-26,8,mon,3639547,298957,3340590
2010-12-26,9,mon,8608561,4193186,4415375
2010-12-26,10,mon,7966389,2103406,5862983
2010-12-26,11,mon,4995123,7298496,-2303373
2010-12-26,12,mon,3175616,3732176,-556560
2010-12-26,13,mon,600705,7241679,-6640974
2010-12-26,14,mon,9857256,9710228,147028
2010-12-26,15,mon,6551325,7726351,-1175026
2010-12-26,16,mon,6393431,4453934,1939497
2010-12-26,17,mon,8838188,9814059,-975871
2010-12-26,18,mon,6992538,5995802,996736
2010-12-26,19,mon,5597088,7246892,-1649804
2010-12-26,20,mon,3417880,5487131,-2069251
2010-12-26,21,mon,3130764,5805416,-2674652
2010-12-26,22,mon,873689,2940688,-2066999
2010-12-26,23,mon,2571538,5339841,-2768303
2010-12-26,0,data,8853449,994929,7858520
2010-12-26,1,data,1175226,5726420,-4551194
2010-12-26,2,data,6856629,5364168,1492461
2010-12-26,3,data,6377693,1399347,4978346
2010-12-26,4,data,6078106,1387646,4690460
2010-12-26,5,data,8098843,6739679,1359164
2010-12-26,6,data,6203492,6890303,-686811
2010-12-26,7,data,2008141,5992595,-3984454
2010-12-26,8,data,5707245,2146221,3561024
2010-12-26,9,data,663512,1808125,-1144613
2010-12-26,10,data,5801663,727132,5074531
2010-12-26,11,data,4702155,1750423,2951732
2010-12-26,12,data,3945980,2166700,1779280
2010-12-26,13,data,5264932,2312672,2952260
2010-12-26,14,data,4987771,9645536,-4657765
2010-12-26,15,data,6808189,2008392,4799797
2010-12-26,16,data,1032333,7621074,-6588741
2010-12-26,17,data,3540129,3947080,-406951
2010-12-26,18,data,4532870,6654074,-2121204
2010-12-26,19,data,5123987,9216740,-4092753
2010-12-26,20,data,402012,2170130,-1768118
2010-12-26,21,data,7917937,1803301,6114636
2010-12-26,22,data,2816774,3877042,-1060268
2010-12-26,23,data,8274148,7855521,418627
2010-12-26,0,voice,7079831,7392548,-312717
2010-12-26,1,voice,2037791,8307084,-6269293
2010-12-26,2,voice,3821614,8416515,-4594901
2010-12-26,3,voice,2320600,4984254,-2663654
2010-12-26,4,voice,7522142,142979,7379163
2010-12-26,5,voice,222136,6924200,-6702064
2010-12-26,6,voice,2632664,5561540,-2928876
2010-12-26,7,voice,6599202,4761017,1838185
2010-12-26,8,voice,3082970,1745302,1337668
2010-12-26,9,voice,8986512,8437242,549270
2010-12-26,10,voice,111926,8422980,-8311054
2010-12-26,11,voice,6016927,7131305,-1114378
2010-12-26,12,voice,715209,7485835,-6770626
2010-12-26,13,voice,1970497,735300,1235197
2010-12-26,14,voice,1631450,5798259,-4166809
2010-12-26,15,voice,6680691,716103,5964588
2010-12-26,16,voice,618247,2919002,-2300755
2010-12-26,17,voice,9323352,6534344,2789008
2010-12-26,18,voice,2172925,8823582,-6650657
2010-12-26,19,voice,7087809,6807109,280700
2010-12-26,20,voice,8794959,4827250,3967709
2010-12-26,21,voice,1255128,7401659,-6146531
2010-12-26,22,voice,1253891,1766692,-512801
2010-12-26,23,voice,2188971,2850565,-661594
2010-12-26,0,sms,605957,288736,317221
2010-12-26,1,sms,3079890,5565557,-2485667
2010-12-26,2,sms,9374417,1675125,7699292
2010-12-26,3,sms,1074882,692503,382379
2010-12-26,4,sms,374264,2514469,-2140205
2010-12-26,5,sms,1949167,1626231,322936
2010-12-26,6,sms,2407430,5089048,-2681618
2010-12-26,7,sms,3191839,230646,2961193
2010-12-26,8,sms,6985905,4541983,2443922
2010-12-26,9,sms,7648778,7998479,-349701
2010-12-26,10,sms,7927700,1921063,6006637
2010-12-26,11,sms,8864427,5314386,3550041
2010-12-26,12,sms,5706136,1133664,4572472
2010-12-26,13,sms,633928,9065756,-8431828
2010-12-26,14,sms,107501,2621658,-2514157
2010-12-26,15,sms,4927485,1739182,3188303
2010-12-26,16,sms,1978971,523060,1455911
2010-12-26,17,sms,181884,1294059,-1112175
2010-12-26,18,sms,600937,8614470,-8013533
2010-12-26,19,sms,1027777,8489852,-7462075
2010-12-26,20,sms,8386743,480625,7906118
2010-12-26,21,sms,2088920,4561811,-2472891
2010-12-26,22,sms,5476785,6334367,-857582
2010-12-26,23,sms,3052014,207775,2844239
2010-12-26,0,clr,7810098,8285435,-475337
2010-12-26,1,clr,7827010,8956218,-1129208
2010-12-26,2,clr,9853088,3769253,6083835
2010-12-26,3,clr,6190717,8430791,-2240074
2010-12-26,4,clr,2707667,502008,2205659
2010-12-26,5,clr,7497550,5475003,2022547
2010-12-26,6,clr,9595753,1482576,8113177
2010-12-26,7,clr,8320198,6283170,2037028
2010-12-26,8,clr,7121833,5608505,1513328
2010-12-26,9,clr,6222544,3613482,2609062
2010-12-26,10,clr,9674383,681483,8992900
2010-12-26,11,clr,3104845,8557442,-5452597
2010-12-26,12,clr,6364401,1893122,4471279
2010-12-26,13,clr,5013735,6093953,-1080218
2010-12-26,14,clr,8633899,3791811,4842088
2010-12-26,15,clr,3542889,3746649,-203760
2010-12-26,16,clr,1688728,9741148,-8052420
2010-12-26,17,clr,5794429,4040256,1754173
2010-12-26,18,clr,1528704,2214242,-685538
2010-12-26,19,clr,3540366,5080363,-1539997
2010-12-26,20,clr,8461586,6163521,2298065
2010-12-26,21,clr,930346,3997241,-3066895
2010-12-26,22,clr,9570978,3902104,5668874
2010-12-26,23,clr,6715659,2668174,4047485
2010-12-27,0,com,7013962,1283989,5729973
2010-12-27,1,com,4652885,5474473,-821588
2010-12-27,2,com,2649743,1791032,858711
2010-12-27,3,com,3591448,2230405,1361043
2010-12-27,4,com,5575512,7320463,-1744951
2010-12-27,5,com,176162,9828354,-9652192
2010-12-27,6,com,5868961,1449132,4419829
2010-12-27,7,com,2689083,1896670,792413
2010-12-27,8,com,4673725,185271,4488454
2010-12-27,9,com,5981758,681821,5299937
2010-12-27,10,com,8390201,2827141,5563060
2010-12-27,11,com,5678567,781834,4896733
2010-12-27,12,com,4788492,2340063,2448429
2010-12-27,13,com,1579298,7633025,-6053727
2010-12-27,14,com,8775748,759097,8016651
2010-12-27,15,com,399315,3507999,-3108684
2010-12-27,16,com,3170682,5426479,-2255797
2010-12-27,17,com,7264340,7083236,181104
2010-12-27,18,com,4784415,6621874,-1837459
2010-12-27,19,com,8034742,1812367,6222375
2010-12-27,20,com,6753623,9914348,-3160725
2010-12-27,21,com,1320339,1714949,-394610
2010-12-27,22,com,4681165,5334926,-653761
2010-12-27,23,com,3455622,7013742,-3558120
2010-12-27,0,vou,7733199,1871657,5861542
2010-12-27,1,vou,9268670,5768726,3499944
2010-12-27,2,vou,1369335,4740255,-3370920
2010-12-27,3,vou,7083216,398366,6684850
2010-12-27,4,vou,32134,7552,24582
2010-12-27,5,vou,1674829,1536835,137994
2010-12-27,6,vou,6917296,8678803,-1761507
2010-12-27,7,vou,3571654,7632329,-4060675
2010-12-27,8,vou,8377764,6792678,1585086
2010-12-27,9,vou,5454396,1303775,4150621
2010-12-27,10,vou,3609417,994848,2614569
2010-12-27,11,vou,9123516,3495778,5627738
2010-12-27,12,vou,3545708,5594042,-2048334
2010-12-27,13,vou,1901302,2969409,-1068107
2010-12-27,14,vou,6783613,2938167,3845446
2010-12-27,15,vou,6134443,1244549,4889894
2010-12-27,16,vou,2512090,2634331,-122241
2010-12-27,17,vou,4083403,5910312,-1826909
2010-12-27,18,vou,7258355,29480,7228875
2010-12-27,19,vou,3483611,2917384,566227
2010-12-27,20,vou,6504390,8220114,-1715724
2010-12-27,21,vou,3318916,2106092,1212824
2010-12-27,22,vou,7436471,6295768,1140703
2010-12-27,23,vou,7351849,3365183,3986666
2010-12-27,0,cm,6311760,9245172,-2933412
2010-12-27,1,cm,504460,2488168,-1983708
2010-12-27,2,cm,9640952,3339942,6301010
2010-12-27,3,cm,3113033,2827357,285676
2010-12-27,4,cm,499611,2320170,-1820559
2010-12-27,5,cm,688991,252230,436761
2010-12-27,6,cm,3120339,7311312,-4190973
2010-12-27,7,cm,2722447,5394085,-2671638
2010-12-27,8,cm,8122224,4705176,3417048
2010-12-27,9,cm,8830833,7282183,1548650
2010-12-27,10,cm,3451048,1493915,1957133
2010-12-27,11,cm,3878415,7828357,-3949942
2010-12-27,12,cm,7913484,7450315,463169
2010-12-27,13,cm,5250042,7124490,-1874448
2010-12-27,14,cm,1008296,4403377,-3395081
2010-12-27,15,cm,4304328,8065023,-3760695
2010-12-27,16,cm,5065603,6970287,-1904684
2010-12-27,17,cm,3785190,9317089,-5531899
2010-12-27,18,cm,902804,9926530,-9023726
2010-12-27,19,cm,8205894,4406671,3799223
2010-12-27,20,cm,1277343,3012305,-1734962
2010-12-27,21,cm,8922930,8924226,-1296
2010-12-27,22,cm,319249,2338899,-2019650
2010-12-27,23,cm,8694130,5336494,3357636
2010-12-27,0,adj,7350601,8826251,-1475650
2010-12-27,1,adj,7675771,7251250,424521
2010-12-27,2,adj,7622212,9176526,-1554314
2010-12-27,3,adj,6986432,5873105,1113327
2010-12-27,4,adj,7376734,3648665,3728069
2010-12-27,5,adj,4399785,3956215,443570
2010-12-27,6,adj,7157589,945313,6212276
2010-12-27,7,adj,5577336,7846442,-2269106
2010-12-27,8,adj,9316988,3537556,5779432
2010-12-27,9,adj,6829884,9989476,-3159592
2010-12-27,10,adj,384524,9594881,-9210357
2010-12-27,11,adj,934295,9829202,-8894907
2010-12-27,12,adj,4049905,2059091,1990814
2010-12-27,13,adj,9858175,6895110,2963065
2010-12-27,14,adj,673870,3189055,-2515185
2010-12-27,15,adj,6609221,2876402,3732819
2010-12-27,16,adj,1227057,996775,230282
2010-12-27,17,adj,8801472,5432098,3369374
2010-12-27,18,adj,5835877,4531435,1304442
2010-12-27,19,adj,1626207,4646575,-3020368
2010-12-27,20,adj,3948438,9651309,-5702871
2010-12-27,21,adj,5447981,200673,5247308
2010-12-27,22,adj,5873063,7399954,-1526891
2010-12-27,23,adj,7210114,7061878,148236
2010-12-27,0,first,3646074,5115144,-1469070
2010-12-27,1,first,4039003,2612459,1426544
2010-12-27,2,first,7748836,1249400,6499436
2010-12-27,3,first,8099712,2924230,5175482
2010-12-27,4,first,5764623,8269908,-2505285
2010-12-27,5,first,5697140,1470102,4227038
2010-12-27,6,first,9984134,9164573,819561
2010-12-27,7,first,1401030,83535,1317495
2010-12-27,8,first,9359609,5466521,3893088
2010-12-27,9,first,4866302,5363177,-496875
2010-12-27,10,first,6572681,7589307,-1016626
2010-12-27,11,first,2578114,4404581,-1826467
2010-12-27,12,first,2518329,5678772,-3160443
2010-12-27,13,first,7182125,9904251,-2722126
2010-12-27,14,first,4275693,8936805,-4661112
2010-12-27,15,first,2871345,8375976,-5504631
2010-12-27,16,first,496125,3875817,-3379692
2010-12-27,17,first,3923795,1806435,2117360
2010-12-27,18,first,5655527,5215416,440111
2010-12-27,19,first,5406707,3537827,1868880
2010-12-27,20,first,8692928,7035071,1657857
2010-12-27,21,first,6901513,7486226,-584713
2010-12-27,22,first,9340749,427988,8912761
2010-12-27,23,first,7001864,4794287,2207577
2010-12-27,0,mon,4578138,4708441,-130303
2010-12-27,1,mon,4333202,6665920,-2332718
2010-12-27,2,mon,476693,6339177,-5862484
2010-12-27,3,mon,7400544,5277021,2123523
2010-12-27,4,mon,5817379,177603,5639776
2010-12-27,5,mon,3104752,4494421,-1389669
2010-12-27,6,mon,5796693,4035876,1760817
2010-12-27,7,mon,8319052,4005395,4313657
2010-12-27,8,mon,7714531,480167,7234364
2010-12-27,9,mon,5403241,1848475,3554766
2010-12-27,10,mon,7535918,6774327,761591
2010-12-27,11,mon,8452046,2898459,5553587
2010-12-27,12,mon,6993546,6616047,377499
2010-12-27,13,mon,4959966,2006646,2953320
2010-12-27,14,mon,9204014,2085857,7118157
2010-12-27,15,mon,8051967,1027726,7024241
2010-12-27,16,mon,4009078,2196566,1812512
2010-12-27,17,mon,8266382,9607335,-1340953
2010-12-27,18,mon,5017763,6384109,-1366346
2010-12-27,19,mon,2923897,6285928,-3362031
2010-12-27,20,mon,4989756,9107156,-4117400
2010-12-27,21,mon,2657108,217355,2439753
2010-12-27,22,mon,861353,8943439,-8082086
2010-12-27,23,mon,2315901,7336546,-5020645
2010-12-27,0,data,4538805,9645150,-5106345
2010-12-27,1,data,5711207,9977739,-4266532
2010-12-27,2,data,2861161,2649673,211488
2010-12-27,3,data,1945913,3366219,-1420306
2010-12-27,4,data,8835991,72116,8763875
2010-12-27,5,data,2286007,1543627,742380
2010-12-27,6,data,44131,9291771,-9247640
2010-12-27,7,data,2391505,8114061,-5722556
2010-12-27,8,data,9529961,2936512,6593449
2010-12-27,9,data,3830009,8082178,-4252169
2010-12-27,10,data,7850775,2535813,5314962
2010-12-27,11,data,5634250,3761833,1872417
2010-12-27,12,data,3487679,556989,2930690
2010-12-27,13,data,3049337,656077,2393260
2010-12-27,14,data,7310684,4940596,2370088
2010-12-27,15,data,2608911,1159020,1449891
2010-12-27,16,data,700185,4401628,-3701443
2010-12-27,17,data,9984953,6950865,3034088
2010-12-27,18,data,2401716,4204154,-1802438
2010-12-27,19,data,3232117,1733064,1499053
2010-12-27,20,data,2323527,4244335,-1920808
2010-12-27,21,data,7292616,8535221,-1242605
2010-12-27,22,data,6140068,9677043,-3536975
2010-12-27,23,data,1375931,1984347,-608416
2010-12-27,0,voice,5292039,4943070,348969
2010-12-27,1,voice,9538949,9689607,-150658
2010-12-27,2,voice,9371511,838259,8533252
2010-12-27,3,voice,2372355,580578,1791777
2010-12-27,4,voice,9527963,8449016,1078947
2010-12-27,5,voice,2666347,1230898,1435449
2010-12-27,6,voice,4494003,8171226,-3677223
2010-12-27,7,voice,5904841,8927882,-3023041
2010-12-27,8,voice,6758028,6583675,174353
2010-12-27,9,voice,9892444,2076043,7816401
2010-12-27,10,voice,470593,931415,-460822
2010-12-27,11,voice,6464750,1660746,4804004
2010-12-27,12,voice,4193705,5201012,-1007307
2010-12-27,13,voice,4789159,3480508,1308651
2010-12-27,14,voice,5550880,2604743,2946137
2010-12-27,15,voice,2973355,8304671,-5331316
2010-12-27,16,voice,5322766,6274782,-952016
2010-12-27,17,voice,243972,9993127,-9749155
2010-12-27,18,voice,418551,4887632,-4469081
2010-12-27,19,voice,4896762,3785041,1111721
2010-12-27,20,voice,8742400,9458685,-716285
2010-12-27,21,voice,4246296,812464,3433832
2010-12-27,22,voice,4426868,2752438,1674430
2010-12-27,23,voice,6515356,6395264,120092
2010-12-27,0,sms,87484,9964051,-9876567
2010-12-27,1,sms,2923339,7139054,-4215715
2010-12-27,2,sms,5459816,2672502,2787314
2010-12-27,3,sms,3902483,6672472,-2769989
2010-12-27,4,sms,2642648,6635123,-3992475
2010-12-27,5,sms,6930268,8402038,-1471770
2010-12-27,6,sms,5097528,7886075,-2788547
2010-12-27,7,sms,993912,8623777,-7629865
2010-12-27,8,sms,78090,5998607,-5920517
2010-12-27,9,sms,848509,905309,-56800
2010-12-27,10,sms,2684903,2175744,509159
2010-12-27,11,sms,5801090,5544909,256181
2010-12-27,12,sms,3329599,5691180,-2361581
2010-12-27,13,sms,9583371,6662979,2920392
2010-12-27,14,sms,8500240,2693305,5806935
2010-12-27,15,sms,3273600,5036110,-1762510
2010-12-27,16,sms,6533286,6307722,225564
2010-12-27,17,sms,8598396,7431210,1167186
2010-12-27,18,sms,7331832,9697682,-2365850
2010-12-27,19,sms,5553742,7203898,-1650156
2010-12-27,20,sms,9808900,4558678,5250222
2010-12-27,21,sms,797632,4732575,-3934943
2010-12-27,22,sms,9981494,8557163,1424331
2010-12-27,23,sms,7378117,6652090,726027
2010-12-27,0,clr,5297381,3949329,1348052
2010-12-27,1,clr,6112592,3773424,2339168
2010-12-27,2,clr,8953830,5881150,3072680
2010-12-27,3,clr,1519496,5316705,-3797209
2010-12-27,4,clr,5667499,8492133,-2824634
2010-12-27,5,clr,9975973,5489431,4486542
2010-12-27,6,clr,3311131,8376610,-5065479
2010-12-27,7,clr,7544528,3774692,3769836
2010-12-27,8,clr,5506389,667681,4838708
2010-12-27,9,clr,1469044,6704771,-5235727
2010-12-27,10,clr,1136974,5394867,-4257893
2010-12-27,11,clr,1426584,2186626,-760042
2010-12-27,12,clr,9888402,1501295,8387107
2010-12-27,13,clr,8678447,7194655,1483792
2010-12-27,14,clr,7656755,8408633,-751878
2010-12-27,15,clr,1584931,355986,1228945
2010-12-27,16,clr,1539672,526693,1012979
2010-12-27,17,clr,5663873,8888324,-3224451
2010-12-27,18,clr,3278731,7912042,-4633311
2010-12-27,19,clr,5618017,108455,5509562
2010-12-27,20,clr,3016261,494456,2521805
2010-12-27,21,clr,2010135,9473698,-7463563
2010-12-27,22,clr,8973741,4331240,4642501
2010-12-27,23,clr,9470786,2097784,7373002
2010-12-28,0,com,1404704,99440,1305264
2010-12-28,1,com,1036682,1739328,-702646
2010-12-28,2,com,9973494,4232312,5741182
2010-12-28,3,com,6735021,9023620,-2288599
2010-12-28,4,com,7611558,824545,6787013
2010-12-28,5,com,246448,2491795,-2245347
2010-12-28,6,com,3601312,9023766,-5422454
2010-12-28,7,com,3542796,7151490,-3608694
2010-12-28,8,com,231477,7728696,-7497219
2010-12-28,9,com,5715422,747662,4967760
2010-12-28,10,com,8698013,8644843,53170
2010-12-28,11,com,4734991,4513573,221418
2010-12-28,12,com,7594274,6756799,837475
2010-12-28,13,com,6668502,5190684,1477818
2010-12-28,14,com,3196441,9224346,-6027905
2010-12-28,15,com,4610050,9371182,-4761132
2010-12-28,16,com,9890126,6423090,3467036
2010-12-28,17,com,2935128,9319655,-6384527
2010-12-28,18,com,9834910,4809515,5025395
2010-12-28,19,com,7220085,4638610,2581475
2010-12-28,20,com,367348,6000435,-5633087
2010-12-28,21,com,7076914,7268631,-191717
2010-12-28,22,com,7270966,1166875,6104091
2010-12-28,23,com,1156344,6720035,-5563691
2010-12-28,0,vou,460625,5919972,-5459347
2010-12-28,1,vou,6024424,8864584,-2840160
2010-12-28,2,vou,1157949,4023235,-2865286
2010-12-28,3,vou,2144677,1824461,320216
2010-12-28,4,vou,6758110,3812782,2945328
2010-12-28,5,vou,2599255,3195885,-596630
2010-12-28,6,vou,1776961,1748007,28954
2010-12-28,7,vou,1130480,6416998,-5286518
2010-12-28,8,vou,2258347,9757734,-7499387
2010-12-28,9,vou,8565003,7845043,719960
2010-12-28,10,vou,4215696,8508028,-4292332
2010-12-28,11,vou,739155,95023,644132
2010-12-28,12,vou,1603059,7413002,-5809943
2010-12-28,13,vou,897,8561147,-8560250
2010-12-28,14,vou,1191376,2118523,-927147
2010-12-28,15,vou,9137813,1637650,7500163
2010-12-28,16,vou,2672021,1838370,833651
2010-12-28,17,vou,5305094,1908266,3396828
2010-12-28,18,vou,3562240,7672634,-4110394
2010-12-28,19,vou,4943981,7189393,-2245412
2010-12-28,20,vou,6035454,5520889,514565
2010-12-28,21,vou,776594,5887888,-5111294
2010-12-28,22,vou,8556047,2234855,6321192
2010-12-28,23,vou,1926941,7163892,-5236951
2010-12-28,0,cm,8852665,6046280,2806385
2010-12-28,1,cm,1606731,5833417,-4226686
2010-12-28,2,cm,3587536,4214084,-626548
2010-12-28,3,cm,1372611,2000963,-628352
2010-12-28,4,cm,4083596,7976187,-3892591
2010-12-28,5,cm,7288050,4354200,2933850
2010-12-28,6,cm,6664985,2947820,3717165
2010-12-28,7,cm,7436294,3248690,4187604
2010-12-28,8,cm,5157257,5931395,-774138
2010-12-28,9,cm,3896278,5098808,-1202530
2010-12-28,10,cm,7110101,1172483,5937618
2010-12-28,11,cm,9355472,6783739,2571733
2010-12-28,12,cm,9669980,7318276,2351704
2010-12-28,13,cm,3475782,3811481,-335699
2010-12-28,14,cm,4838987,1829785,3009202
2010-12-28,15,cm,6739936,7465392,-725456
2010-12-28,16,cm,2482045,8473348,-5991303
2010-12-28,17,cm,2328907,3427534,-1098627
2010-12-28,18,cm,6812755,7690508,-877753
2010-12-28,19,cm,2744339,1093855,1650484
2010-12-28,20,cm,2778385,43870,2734515
2010-12-28,21,cm,8829631,6442336,2387295
2010-12-28,22,cm,6193538,8275188,-2081650
2010-12-28,23,cm,6848317,1766873,5081444
2010-12-28,0,adj,9033018,5387113,3645905
2010-12-28,1,adj,4597933,3799515,798418
2010-12-28,2,adj,6201424,6971027,-769603
2010-12-28,3,adj,3304598,2677408,627190
2010-12-28,4,adj,3201827,9869482,-6667655
2010-12-28,5,adj,2608743,34484,2574259
2010-12-28,6,adj,4899192,8701327,-3802135
2010-12-28,7,adj,6584056,5704212,879844
2010-12-28,8,adj,5911833,1226018,4685815
2010-12-28,9,adj,1252192,6552196,-5300004
2010-12-28,10,adj,4023573,3397219,626354
2010-12-28,11,adj,735214,8447668,-7712454
2010-12-28,12,adj,5567402,6718582,-1151180
2010-12-28,13,adj,3522653,8774889,-5252236
2010-12-28,14,adj,3300627,2326318,974309
2010-12-28,15,adj,8773950,1711018,7062932
2010-12-28,16,adj,2189320,9338929,-7149609
2010-12-28,17,adj,585185,1245890,-660705
2010-12-28,18,adj,7085141,6362536,722605
2010-12-28,19,adj,8453195,4758147,3695048
2010-12-28,20,adj,3944570,6951757,-3007187
2010-12-28,21,adj,3368718,9922660,-6553942
2010-12-28,22,adj,3597753,5114243,-1516490
2010-12-28,23,adj,6218291,6739772,-521481
2010-12-28,0,first,218181,7593980,-7375799
2010-12-28,1,first,3539550,7252976,-3713426
2010-12-28,2,first,4520021,664992,3855029
2010-12-28,3,first,7755566,5055033,2700533
2010-12-28,4,first,9997674,1251222,8746452
2010-12-28,5,first,4851262,9966220,-5114958
2010-12-28,6,first,2899066,6245448,-3346382
2010-12-28,7,first,786528,2428149,-1641621
2010-12-28,8,first,4224427,5975634,-1751207
2010-12-28,9,first,8172890,8076725,96165
2010-12-28,10,first,7064816,3498413,3566403
2010-12-28,11,first,9443207,4276354,5166853
2010-12-28,12,first,7101245,7919986,-818741
2010-12-28,13,first,5201257,3426830,1774427
2010-12-28,14,first,7419821,7508792,-88971
2010-12-28,15,first,273073,5490423,-5217350
2010-12-28,16,first,8988209,4230918,4757291
2010-12-28,17,first,9960720,5881795,4078925
2010-12-28,18,first,7840284,389972,7450312
2010-12-28,19,first,9893316,1656215,8237101
2010-12-28,20,first,1937096,9369811,-7432715
2010-12-28,21,first,1453287,1842238,-388951
2010-12-28,22,first,1996156,7924801,-5928645
2010-12-28,23,first,2262861,2962484,-699623
2010-12-28,0,mon,7055859,6379437,676422
2010-12-28,1,mon,5716962,5007711,709251
2010-12-28,2,mon,325192,5005537,-4680345
2010-12-28,3,mon,6732855,6316242,416613
2010-12-28,4,mon,6627511,6213763,413748
2010-12-28,5,mon,8420634,5728233,2692401
2010-12-28,6,mon,2201643,9953181,-7751538
2010-12-28,7,mon,2067971,173588,1894383
2010-12-28,8,mon,5245025,9239556,-3994531
2010-12-28,9,mon,6557234,7031250,-474016
2010-12-28,10,mon,6127336,4820258,1307078
2010-12-28,11,mon,3291533,9664592,-6373059
2010-12-28,12,mon,7337389,3040882,4296507
2010-12-28,13,mon,9191592,81153,9110439
2010-12-28,14,mon,6392009,7865777,-1473768
2010-12-28,15,mon,4542401,2182101,2360300
2010-12-28,16,mon,7332448,2577915,4754533
2010-12-28,17,mon,7458287,4242689,3215598
2010-12-28,18,mon,8693459,4327764,4365695
2010-12-28,19,mon,1984599,6117649,-4133050
2010-12-28,20,mon,8281225,9692529,-1411304
2010-12-28,21,mon,8848501,3158149,5690352
2010-12-28,22,mon,3049892,4236017,-1186125
2010-12-28,23,mon,4655272,744743,3910529
2010-12-28,0,data,1412744,3703310,-2290566
2010-12-28,1,data,6401626,6534529,-132903
2010-12-28,2,data,6537877,8801736,-2263859
2010-12-28,3,data,6504526,998792,5505734
2010-12-28,4,data,2005241,5848878,-3843637
2010-12-28,5,data,9716695,9761052,-44357
2010-12-28,6,data,149335,953350,-804015
2010-12-28,7,data,8338231,6068406,2269825
2010-12-28,8,data,1202687,2662313,-1459626
2010-12-28,9,data,9509646,4329405,5180241
2010-12-28,10,data,7272771,6401119,871652
2010-12-28,11,data,5611749,7944604,-2332855
2010-12-28,12,data,7528747,444352,7084395
2010-12-28,13,data,7563648,5906683,1656965
2010-12-28,14,data,1870113,1428013,442100
2010-12-28,15,data,9041985,4023269,5018716
2010-12-28,16,data,3355367,6765717,-3410350
2010-12-28,17,data,2659586,7127090,-4467504
2010-12-28,18,data,6375006,1741867,4633139
2010-12-28,19,data,149243,1718764,-1569521
2010-12-28,20,data,1092966,5231478,-4138512
2010-12-28,21,data,5393597,3907545,1486052
2010-12-28,22,data,5463703,8054111,-2590408
2010-12-28,23,data,7921961,3825092,4096869
2010-12-28,0,voice,3017542,2066302,951240
2010-12-28,1,voice,6866914,7470585,-603671
2010-12-28,2,voice,9696894,8750407,946487
2010-12-28,3,voice,9861795,9648186,213609
2010-12-28,4,voice,1444684,1807545,-362861
2010-12-28,5,voice,7374035,3940912,3433123
2010-12-28,6,voice,4917361,3780672,1136689
2010-12-28,7,voice,9066936,2576684,6490252
2010-12-28,8,voice,6291418,3137051,3154367
2010-12-28,9,voice,1744776,703796,1040980
2010-12-28,10,voice,6277775,3637514,2640261
2010-12-28,11,voice,523631,155284,368347
2010-12-28,12,voice,567952,9699459,-9131507
2010-12-28,13,voice,1099788,7081535,-5981747
2010-12-28,14,voice,5563341,3667612,1895729
2010-12-28,15,voice,4810142,6688499,-1878357
2010-12-28,16,voice,4629582,1336291,3293291
2010-12-28,17,voice,7718297,8329137,-610840
2010-12-28,18,voice,3364165,7724052,-4359887
2010-12-28,19,voice,4069154,2741755,1327399
2010-12-28,20,voice,7552660,231791,7320869
2010-12-28,21,voice,5850270,3617966,2232304
2010-12-28,22,voice,9915184,2632668,7282516
2010-12-28,23,voice,3418786,6144141,-2725355
2010-12-28,0,sms,233080,6729747,-6496667
2010-12-28,1,sms,7388541,6641036,747505
2010-12-28,2,sms,9694839,3036103,6658736
2010-12-28,3,sms,7087009,5226444,1860565
2010-12-28,4,sms,465431,3970327,-3504896
2010-12-28,5,sms,7642494,9175737,-1533243
2010-12-28,6,sms,7713827,8049042,-335215
2010-12-28,7,sms,4837348,6689165,-1851817
2010-12-28,8,sms,9815067,4959383,4855684
2010-12-28,9,sms,7439386,7929374,-489988
2010-12-28,10,sms,9821850,2755600,7066250
2010-12-28,11,sms,6628854,9388756,-2759902
2010-12-28,12,sms,5415097,5855427,-440330
2010-12-28,13,sms,2106158,3678821,-1572663
2010-12-28,14,sms,4408548,3857678,550870
2010-12-28,15,sms,8916146,4520801,4395345
2010-12-28,16,sms,2688478,5998953,-3310475
2010-12-28,17,sms,904855,1851911,-947056
2010-12-28,18,sms,6162965,9637460,-3474495
2010-12-28,19,sms,886802,7013218,-6126416
2010-12-28,20,sms,6340561,7982530,-1641969
2010-12-28,21,sms,3027250,4829989,-1802739
2010-12-28,22,sms,9489624,5823551,3666073
2010-12-28,23,sms,6468621,6724981,-256360
2010-12-28,0,clr,5757051,2585507,3171544
2010-12-28,1,clr,1875332,6466887,-4591555
2010-12-28,2,clr,9471478,4072549,5398929
2010-12-28,3,clr,9906687,8212596,1694091
2010-12-28,4,clr,8585026,729013,7856013
2010-12-28,5,clr,8812964,1423604,7389360
2010-12-28,6,clr,6081154,8972015,-2890861
2010-12-28,7,clr,8809487,9601367,-791880
2010-12-28,8,clr,9389602,1404360,7985242
2010-12-28,9,clr,2689464,530525,2158939
2010-12-28,10,clr,136721,8761392,-8624671
2010-12-28,11,clr,7120197,7795084,-674887
2010-12-28,12,clr,813227,2647042,-1833815
2010-12-28,13,clr,4935257,3889474,1045783
2010-12-28,14,clr,4120891,7006628,-2885737
2010-12-28,15,clr,8210836,9047010,-836174
2010-12-28,16,clr,1731845,3206490,-1474645
2010-12-28,17,clr,9330491,6704175,2626316
2010-12-28,18,clr,3938240,4650265,-712025
2010-12-28,19,clr,6446739,2009030,4437709
2010-12-28,20,clr,5982553,2005289,3977264
2010-12-28,21,clr,7937496,8076958,-139462
2010-12-28,22,clr,9558323,5562169,3996154
2010-12-28,23,clr,7443062,9218849,-1775787
2010-12-29,0,com,182245,4574489,-4392244
2010-12-29,1,com,5918363,5847597,70766
2010-12-29,2,com,8249736,5110600,3139136
2010-12-29,3,com,7646885,2306300,5340585
2010-12-29,4,com,2085325,2715084,-629759
2010-12-29,5,com,1440773,7533863,-6093090
2010-12-29,6,com,7715029,487719,7227310
2010-12-29,7,com,3016440,1470050,1546390
2010-12-29,8,com,2610825,6828125,-4217300
2010-12-29,9,com,2746276,150938,2595338
2010-12-29,10,com,4863,5537348,-5532485
2010-12-29,11,com,2255710,2489679,-233969
2010-12-29,12,com,8549422,1792085,6757337
2010-12-29,13,com,2598983,4923924,-2324941
2010-12-29,14,com,398247,1079099,-680852
2010-12-29,15,com,5305118,6721030,-1415912
2010-12-29,16,com,1742600,1686257,56343
2010-12-29,17,com,515928,1562754,-1046826
2010-12-29,18,com,697217,671280,25937
2010-12-29,19,com,9396922,5257652,4139270
2010-12-29,20,com,2847539,6484072,-3636533
2010-12-29,21,com,5490759,8099432,-2608673
2010-12-29,22,com,9060494,2397327,6663167
2010-12-29,23,com,6523285,5939319,583966
2010-12-29,0,vou,2810107,2702319,107788
2010-12-29,1,vou,8202759,3067024,5135735
2010-12-29,2,vou,8280885,1569364,6711521
2010-12-29,3,vou,3494735,6088799,-2594064
2010-12-29,4,vou,2172827,3649742,-1476915
2010-12-29,5,vou,2044198,4013314,-1969116
2010-12-29,6,vou,2989988,1506984,1483004
2010-12-29,7,vou,4104832,3162450,942382
2010-12-29,8,vou,3544895,3871996,-327101
2010-12-29,9,vou,8615262,5692589,2922673
2010-12-29,10,vou,8127922,2959358,5168564
2010-12-29,11,vou,5064033,72922,4991111
2010-12-29,12,vou,5446330,4789329,657001
2010-12-29,13,vou,7633053,9458061,-1825008
2010-12-29,14,vou,5958063,780998,5177065
2010-12-29,15,vou,6123623,4123966,1999657
2010-12-29,16,vou,8100742,8508664,-407922
2010-12-29,17,vou,5077196,3573337,1503859
2010-12-29,18,vou,2532775,878518,1654257
2010-12-29,19,vou,3231316,2981297,250019
2010-12-29,20,vou,6691458,5603866,1087592
2010-12-29,21,vou,1925702,6764426,-4838724
2010-12-29,22,vou,9347962,9427767,-79805
2010-12-29,23,vou,7565655,5244409,2321246
2010-12-29,0,cm,8943486,3717132,5226354
2010-12-29,1,cm,6939062,4436017,2503045
2010-12-29,2,cm,8710874,1573720,7137154
2010-12-29,3,cm,1805077,6974452,-5169375
2010-12-29,4,cm,8132301,9043661,-911360
2010-12-29,5,cm,3210816,1358148,1852668
2010-12-29,6,cm,8513415,2965066,5548349
2010-12-29,7,cm,211713,2250713,-2039000
2010-12-29,8,cm,889256,1678106,-788850
2010-12-29,9,cm,688358,1727557,-1039199
2010-12-29,10,cm,7706411,1956115,5750296
2010-12-29,11,cm,4505857,4079105,426752
2010-12-29,12,cm,704130,9919444,-9215314
2010-12-29,13,cm,8233540,9132958,-899418
2010-12-29,14,cm,7765705,4028710,3736995
2010-12-29,15,cm,5714437,3237766,2476671
2010-12-29,16,cm,3140490,1490773,1649717
2010-12-29,17,cm,9924556,4684563,5239993
2010-12-29,18,cm,8198107,4950825,3247282
2010-12-29,19,cm,2340328,3952920,-1612592
2010-12-29,20,cm,9836453,1905952,7930501
2010-12-29,21,cm,8200337,8106137,94200
2010-12-29,22,cm,2308721,7403363,-5094642
2010-12-29,23,cm,4529882,1360908,3168974
2010-12-29,0,adj,8707541,6814039,1893502
2010-12-29,1,adj,6899046,8981188,-2082142
2010-12-29,2,adj,8384173,7141273,1242900
2010-12-29,3,adj,4840297,5714876,-874579
2010-12-29,4,adj,2444701,788591,1656110
2010-12-29,5,adj,2240480,1433571,806909
2010-12-29,6,adj,6706579,1934501,4772078
2010-12-29,7,adj,6389114,7514898,-1125784
2010-12-29,8,adj,5226694,3043966,2182728
2010-12-29,9,adj,9020682,9975435,-954753
2010-12-29,10,adj,2614854,7699878,-5085024
2010-12-29,11,adj,9681702,4383264,5298438
2010-12-29,12,adj,9965740,8005419,1960321
2010-12-29,13,adj,4253696,5246033,-992337
2010-12-29,14,adj,8846633,7236356,1610277
2010-12-29,15,adj,4284568,211309,4073259
2010-12-29,16,adj,8561976,8850702,-288726
2010-12-29,17,adj,6965882,8947342,-1981460
2010-12-29,18,adj,340005,1339997,-999992
2010-12-29,19,adj,879635,3237875,-2358240
2010-12-29,20,adj,4915776,2058460,2857316
2010-12-29,21,adj,5818635,5739127,79508
2010-12-29,22,adj,8874253,3288289,5585964
2010-12-29,23,adj,3128443,9696088,-6567645
2010-12-29,0,first,978212,8734620,-7756408
2010-12-29,1,first,2410445,908488,1501957
2010-12-29,2,first,334745,9937814,-9603069
2010-12-29,3,first,104434,4096720,-3992286
2010-12-29,4,first,1244129,821264,422865
2010-12-29,5,first,4521986,3257852,1264134
2010-12-29,6,first,1172427,3934793,-2762366
2010-12-29,7,first,466616,2039753,-1573137
2010-12-29,8,first,5922430,3206001,2716429
2010-12-29,9,first,5251712,3244197,2007515
2010-12-29,10,first,4648189,8670724,-4022535
2010-12-29,11,first,1118872,5933473,-4814601
2010-12-29,12,first,670518,3714481,-3043963
2010-12-29,13,first,2861560,3330168,-468608
2010-12-29,14,first,6018980,4217744,1801236
2010-12-29,15,first,983016,6613139,-5630123
2010-12-29,16,first,9280087,1820324,7459763
2010-12-29,17,first,686162,3143150,-2456988
2010-12-29,18,first,5919553,3529589,2389964
2010-12-29,19,first,8460948,4749009,3711939
2010-12-29,20,first,164571,430600,-266029
2010-12-29,21,first,9875672,719944,9155728
2010-12-29,22,first,1893569,1050046,843523
2010-12-29,23,first,4408770,8429765,-4020995
2010-12-29,0,mon,2714501,9665107,-6950606
2010-12-29,1,mon,3325868,4952683,-1626815
2010-12-29,2,mon,1215640,844278,371362
2010-12-29,3,mon,1572570,5271320,-3698750
2010-12-29,4,mon,1623258,5051638,-3428380
2010-12-29,5,mon,2166389,8975324,-6808935
2010-12-29,6,mon,2408499,3509460,-1100961
2010-12-29,7,mon,769290,8860829,-8091539
2010-12-29,8,mon,2013446,1592450,420996
2010-12-29,9,mon,532991,1750909,-1217918
2010-12-29,10,mon,5533977,9545046,-4011069
2010-12-29,11,mon,4212916,8408548,-4195632
2010-12-29,12,mon,3803188,6122648,-2319460
2010-12-29,13,mon,4873819,414911,4458908
2010-12-29,14,mon,711273,370976,340297
2010-12-29,15,mon,7019126,2349918,4669208
2010-12-29,16,mon,6690400,6554510,135890
2010-12-29,17,mon,2995562,2084457,911105
2010-12-29,18,mon,8019510,3670363,4349147
2010-12-29,19,mon,2554759,1086642,1468117
2010-12-29,20,mon,6441160,5147513,1293647
2010-12-29,21,mon,4121643,4686950,-565307
2010-12-29,22,mon,9467521,4423838,5043683
2010-12-29,23,mon,9782960,6888354,2894606
2010-12-29,0,data,4832665,2327690,2504975
2010-12-29,1,data,3617241,607355,3009886
2010-12-29,2,data,7329534,4181875,3147659
2010-12-29,3,data,6311481,7586084,-1274603
2010-12-29,4,data,7225168,644366,6580802
2010-12-29,5,data,2237825,5537529,-3299704
2010-12-29,6,data,5800982,8767529,-2966547
2010-12-29,7,data,8328042,6785063,1542979
2010-12-29,8,data,3206422,7004193,-3797771
2010-12-29,9,data,4591232,2384336,2206896
2010-12-29,10,data,5751638,8592825,-2841187
2010-12-29,11,data,509925,1436876,-926951
2010-12-29,12,data,453230,4370825,-3917595
2010-12-29,13,data,9007065,2731373,6275692
2010-12-29,14,data,1755713,7695294,-5939581
2010-12-29,15,data,8370468,9273279,-902811
2010-12-29,16,data,8540739,9877587,-1336848
2010-12-29,17,data,5356025,9804853,-4448828
2010-12-29,18,data,2109031,5417642,-3308611
2010-12-29,19,data,6885672,6938317,-52645
2010-12-29,20,data,9521078,6586597,2934481
2010-12-29,21,data,8997197,550680,8446517
2010-12-29,22,data,803361,2711289,-1907928
2010-12-29,23,data,4915740,1058913,3856827
2010-12-29,0,voice,6144229,6655034,-510805
2010-12-29,1,voice,3026141,5623840,-2597699
2010-12-29,2,voice,2261297,1754494,506803
2010-12-29,3,voice,3585200,4021908,-436708
2010-12-29,4,voice,5936659,2428479,3508180
2010-12-29,5,voice,4661139,3498575,1162564
2010-12-29,6,voice,1461761,6554471,-5092710
2010-12-29,7,voice,2806649,5140649,-2334000
2010-12-29,8,voice,8585137,930262,7654875
2010-12-29,9,voice,9930533,3083066,6847467
2010-12-29,10,voice,651125,6113168,-5462043
2010-12-29,11,voice,2318,7938029,-7935711
2010-12-29,12,voice,7727811,7547494,180317
2010-12-29,13,voice,6056429,382810,5673619
2010-12-29,14,voice,3030969,1137785,1893184
2010-12-29,15,voice,8441979,8146788,295191
2010-12-29,16,voice,3530680,2935703,594977
2010-12-29,17,voice,8656942,8716988,-60046
2010-12-29,18,voice,2746634,3987876,-1241242
2010-12-29,19,voice,2350472,9311001,-6960529
2010-12-29,20,voice,8536049,8738557,-202508
2010-12-29,21,voice,8540769,4952152,3588617
2010-12-29,22,voice,2804703,6441865,-3637162
2010-12-29,23,voice,4953123,3769765,1183358
2010-12-29,0,sms,302326,1631218,-1328892
2010-12-29,1,sms,9270769,6564850,2705919
2010-12-29,2,sms,6825633,1699470,5126163
2010-12-29,3,sms,342219,4271650,-3929431
2010-12-29,4,sms,4258798,4501999,-243201
2010-12-29,5,sms,5190729,7053202,-1862473
2010-12-29,6,sms,1279600,79940,1199660
2010-12-29,7,sms,6515875,4816820,1699055
2010-12-29,8,sms,6914031,7476148,-562117
2010-12-29,9,sms,197740,4492387,-4294647
2010-12-29,10,sms,2386641,5041127,-2654486
2010-12-29,11,sms,4764529,9960979,-5196450
2010-12-29,12,sms,2857312,5181041,-2323729
2010-12-29,13,sms,4015301,9834123,-5818822
2010-12-29,14,sms,9647261,7082368,2564893
2010-12-29,15,sms,3561060,2616824,944236
2010-12-29,16,sms,34920,1544613,-1509693
2010-12-29,17,sms,6354750,6038778,315972
2010-12-29,18,sms,4801060,3308079,1492981
2010-12-29,19,sms,1870926,2728953,-858027
2010-12-29,20,sms,6198741,9852685,-3653944
2010-12-29,21,sms,3482410,5149551,-1667141
2010-12-29,22,sms,2254554,7895738,-5641184
2010-12-29,23,sms,8362416,3346710,5015706
2010-12-29,0,clr,3213325,8240015,-5026690
2010-12-29,1,clr,4083348,624062,3459286
2010-12-29,2,clr,9166769,927254,8239515
2010-12-29,3,clr,7622253,673345,6948908
2010-12-29,4,clr,2808691,6266249,-3457558
2010-12-29,5,clr,9882276,8650421,1231855
2010-12-29,6,clr,8570261,778503,7791758
2010-12-29,7,clr,2536393,5602572,-3066179
2010-12-29,8,clr,4441746,1894329,2547417
2010-12-29,9,clr,5443899,5478645,-34746
2010-12-29,10,clr,9152178,8584260,567918
2010-12-29,11,clr,8106673,1230124,6876549
2010-12-29,12,clr,5098187,6629981,-1531794
2010-12-29,13,clr,370937,1151410,-780473
2010-12-29,14,clr,6478739,9548770,-3070031
2010-12-29,15,clr,654410,1255581,-601171
2010-12-29,16,clr,582846,3623284,-3040438
2010-12-29,17,clr,5621100,5891939,-270839
2010-12-29,18,clr,5179418,3283914,1895504
2010-12-29,19,clr,5978315,663476,5314839
2010-12-29,20,clr,7425554,7891462,-465908
2010-12-29,21,clr,302955,7108226,-6805271
2010-12-29,22,clr,4636117,9587160,-4951043
2010-12-29,23,clr,5766938,4550363,1216575
2010-12-30,0,com,3460305,6858432,-3398127
2010-12-30,1,com,3770077,5334780,-1564703
2010-12-30,2,com,6771765,7519046,-747281
2010-12-30,3,com,1742318,5935153,-4192835
2010-12-30,4,com,659510,321472,338038
2010-12-30,5,com,8679101,2923357,5755744
2010-12-30,6,com,1583775,8333848,-6750073
2010-12-30,7,com,7585651,7428767,156884
2010-12-30,8,com,4346306,8160938,-3814632
2010-12-30,9,com,3993788,3138559,855229
2010-12-30,10,com,6773509,350336,6423173
2010-12-30,11,com,6987951,2097027,4890924
2010-12-30,12,com,2379966,138905,2241061
2010-12-30,13,com,5854362,9876719,-4022357
2010-12-30,14,com,4184345,4112251,72094
2010-12-30,15,com,5714081,7611402,-1897321
2010-12-30,16,com,253904,5216618,-4962714
2010-12-30,17,com,8408139,1949221,6458918
2010-12-30,18,com,1273182,3906738,-2633556
2010-12-30,19,com,623676,2987595,-2363919
2010-12-30,20,com,9604473,6518600,3085873
2010-12-30,21,com,498033,2406701,-1908668
2010-12-30,22,com,28524,3044338,-3015814
2010-12-30,23,com,731976,9673217,-8941241
2010-12-30,0,vou,871026,5254455,-4383429
2010-12-30,1,vou,3658645,471798,3186847
2010-12-30,2,vou,2730969,99411,2631558
2010-12-30,3,vou,4953656,2305953,2647703
2010-12-30,4,vou,1190626,6413335,-5222709
2010-12-30,5,vou,7237737,7383802,-146065
2010-12-30,6,vou,6458173,3624857,2833316
2010-12-30,7,vou,7868288,147909,7720379
2010-12-30,8,vou,9781141,9884447,-103306
2010-12-30,9,vou,7571848,1431732,6140116
2010-12-30,10,vou,4344333,1648162,2696171
2010-12-30,11,vou,7537063,6622329,914734
2010-12-30,12,vou,2890214,7158454,-4268240
2010-12-30,13,vou,8050337,4001972,4048365
2010-12-30,14,vou,5654314,4053613,1600701
2010-12-30,15,vou,7200916,772130,6428786
2010-12-30,16,vou,8595054,8807747,-212693
2010-12-30,17,vou,7041094,1290692,5750402
2010-12-30,18,vou,1193729,9894832,-8701103
2010-12-30,19,vou,1954764,5623117,-3668353
2010-12-30,20,vou,3962324,4512651,-550327
2010-12-30,21,vou,6218816,811878,5406938
2010-12-30,22,vou,8307779,2714873,5592906
2010-12-30,23,vou,877863,8059531,-7181668
2010-12-30,0,cm,4163461,8064796,-3901335
2010-12-30,1,cm,7884958,7230440,654518
2010-12-30,2,cm,1951133,5690861,-3739728
2010-12-30,3,cm,3171170,1203096,1968074
2010-12-30,4,cm,8753019,4600021,4152998
2010-12-30,5,cm,58635,1643512,-1584877
2010-12-30,6,cm,3962829,4007641,-44812
2010-12-30,7,cm,5232236,3076548,2155688
2010-12-30,8,cm,5070082,6505835,-1435753
2010-12-30,9,cm,8542569,1435603,7106966
2010-12-30,10,cm,1871743,1546775,324968
2010-12-30,11,cm,9262267,6558995,2703272
2010-12-30,12,cm,3373553,3677967,-304414
2010-12-30,13,cm,9020584,6881154,2139430
2010-12-30,14,cm,9093999,5545268,3548731
2010-12-30,15,cm,643835,483768,160067
2010-12-30,16,cm,7896344,7712236,184108
2010-12-30,17,cm,7252523,2378043,4874480
2010-12-30,18,cm,1209964,2999994,-1790030
2010-12-30,19,cm,4606008,5337034,-731026
2010-12-30,20,cm,1169772,5300835,-4131063
2010-12-30,21,cm,8968953,9036068,-67115
2010-12-30,22,cm,2963309,5092402,-2129093
2010-12-30,23,cm,9954128,3040798,6913330
2010-12-30,0,adj,4419126,6820508,-2401382
2010-12-30,1,adj,9611098,4753283,4857815
2010-12-30,2,adj,719877,8694424,-7974547
2010-12-30,3,adj,6485677,4910053,1575624
2010-12-30,4,adj,8560362,9684398,-1124036
2010-12-30,5,adj,786581,2110206,-1323625
2010-12-30,6,adj,1693966,2696733,-1002767
2010-12-30,7,adj,3899094,5046360,-1147266
2010-12-30,8,adj,1986447,6143918,-4157471
2010-12-30,9,adj,3610746,5534990,-1924244
2010-12-30,10,adj,7413246,7789298,-376052
2010-12-30,11,adj,8211938,5178151,3033787
2010-12-30,12,adj,4621944,5039094,-417150
2010-12-30,13,adj,6835663,7752054,-916391
2010-12-30,14,adj,4024873,953651,3071222
2010-12-30,15,adj,7408200,6743575,664625
2010-12-30,16,adj,8935251,6436066,2499185
2010-12-30,17,adj,7870514,6942290,928224
2010-12-30,18,adj,2372497,2293557,78940
2010-12-30,19,adj,5616151,9945162,-4329011
2010-12-30,20,adj,6793731,8322865,-1529134
2010-12-30,21,adj,4725306,1282507,3442799
2010-12-30,22,adj,4950491,9146237,-4195746
2010-12-30,23,adj,9159329,8685693,473636
2010-12-30,0,first,9616322,5115622,4500700
2010-12-30,1,first,4277589,2119247,2158342
2010-12-30,2,first,8771195,5812204,2958991
2010-12-30,3,first,8672118,4934565,3737553
2010-12-30,4,first,1918963,2451906,-532943
2010-12-30,5,first,8530740,7686200,844540
2010-12-30,6,first,2592926,189898,2403028
2010-12-30,7,first,379659,1766718,-1387059
2010-12-30,8,first,1820051,4434097,-2614046
2010-12-30,9,first,1779125,1193612,585513
2010-12-30,10,first,9044690,1582048,7462642
2010-12-30,11,first,3337551,927114,2410437
2010-12-30,12,first,2068978,2913913,-844935
2010-12-30,13,first,5123824,9773325,-4649501
2010-12-30,14,first,2494125,5788579,-3294454
2010-12-30,15,first,4034837,5623997,-1589160
2010-12-30,16,first,210392,9873005,-9662613
2010-12-30,17,first,338439,588209,-249770
2010-12-30,18,first,3155756,7346258,-4190502
2010-12-30,19,first,3804516,2646765,1157751
2010-12-30,20,first,8693831,6301372,2392459
2010-12-30,21,first,7070510,9489868,-2419358
2010-12-30,22,first,5111280,2999776,2111504
2010-12-30,23,first,4404368,4305841,98527
2010-12-30,0,mon,1323254,2968882,-1645628
2010-12-30,1,mon,5649352,8228464,-2579112
2010-12-30,2,mon,3200484,1028572,2171912
2010-12-30,3,mon,353590,7075117,-6721527
2010-12-30,4,mon,8644528,6294494,2350034
2010-12-30,5,mon,1510795,2621175,-1110380
2010-12-30,6,mon,8101122,916634,7184488
2010-12-30,7,mon,6500112,5296801,1203311
2010-12-30,8,mon,1885755,7379628,-5493873
2010-12-30,9,mon,18849,1426067,-1407218
2010-12-30,10,mon,4637806,3191067,1446739
2010-12-30,11,mon,3291161,4745924,-1454763
2010-12-30,12,mon,1752548,4498746,-2746198
2010-12-30,13,mon,7979591,5912064,2067527
2010-12-30,14,mon,624054,638223,-14169
2010-12-30,15,mon,7043559,7162329,-118770
2010-12-30,16,mon,3660342,4757010,-1096668
2010-12-30,17,mon,5184971,4542802,642169
2010-12-30,18,mon,3759096,8212287,-4453191
2010-12-30,19,mon,5872643,9599430,-3726787
2010-12-30,20,mon,7974021,8287597,-313576
2010-12-30,21,mon,3653086,9807693,-6154607
2010-12-30,22,mon,4544925,8420432,-3875507
2010-12-30,23,mon,7673547,3491072,4182475
2010-12-30,0,data,2119946,1251020,868926
2010-12-30,1,data,7485893,6679887,806006
2010-12-30,2,data,4775692,7331408,-2555716
2010-12-30,3,data,6232453,6437256,-204803
2010-12-30,4,data,2262912,3540023,-1277111
2010-12-30,5,data,8645071,875935,7769136
2010-12-30,6,data,7933945,6088984,1844961
2010-12-30,7,data,515460,3033424,-2517964
2010-12-30,8,data,9842949,3275641,6567308
2010-12-30,9,data,4172895,1577362,2595533
2010-12-30,10,data,1349435,8185676,-6836241
2010-12-30,11,data,438164,8697539,-8259375
2010-12-30,12,data,789723,4809024,-4019301
2010-12-30,13,data,1861841,5951723,-4089882
2010-12-30,14,data,6618987,4592375,2026612
2010-12-30,15,data,126376,5340607,-5214231
2010-12-30,16,data,3808030,6606878,-2798848
2010-12-30,17,data,9939023,8551156,1387867
2010-12-30,18,data,6195038,8691684,-2496646
2010-12-30,19,data,657206,8766529,-8109323
2010-12-30,20,data,2663525,2323267,340258
2010-12-30,21,data,7576224,7599719,-23495
2010-12-30,22,data,7462774,1628854,5833920
2010-12-30,23,data,2439553,4338896,-1899343
2010-12-30,0,voice,6520574,9615152,-3094578
2010-12-30,1,voice,4607377,1203111,3404266
2010-12-30,2,voice,1673876,7985860,-6311984
2010-12-30,3,voice,7080331,7615650,-535319
2010-12-30,4,voice,4625398,4951428,-326030
2010-12-30,5,voice,5193988,3234244,1959744
2010-12-30,6,voice,503445,6772650,-6269205
2010-12-30,7,voice,8330835,3695909,4634926
2010-12-30,8,voice,1766,2341839,-2340073
2010-12-30,9,voice,2695319,9239118,-6543799
2010-12-30,10,voice,4415361,1863286,2552075
2010-12-30,11,voice,5052363,3685896,1366467
2010-12-30,12,voice,9466504,2267904,7198600
2010-12-30,13,voice,2006277,5532513,-3526236
2010-12-30,14,voice,3227600,3546590,-318990
2010-12-30,15,voice,7257062,2165966,5091096
2010-12-30,16,voice,1574247,1995128,-420881
2010-12-30,17,voice,6158091,113460,6044631
2010-12-30,18,voice,356884,632841,-275957
2010-12-30,19,voice,511756,6723853,-6212097
2010-12-30,20,voice,8603467,5204166,3399301
2010-12-30,21,voice,1481030,1479728,1302
2010-12-30,22,voice,7584514,5360973,2223541
2010-12-30,23,voice,5504685,6513644,-1008959
2010-12-30,0,sms,2410608,3797345,-1386737
2010-12-30,1,sms,2037850,4526970,-2489120
2010-12-30,2,sms,4928457,2272729,2655728
2010-12-30,3,sms,1540375,4955144,-3414769
2010-12-30,4,sms,4356576,7129193,-2772617
2010-12-30,5,sms,6050447,1714572,4335875
2010-12-30,6,sms,5489203,1816177,3673026
2010-12-30,7,sms,1658579,3135439,-1476860
2010-12-30,8,sms,5881155,7915617,-2034462
2010-12-30,9,sms,5879556,3000131,2879425
2010-12-30,10,sms,6385566,6120836,264730
2010-12-30,11,sms,3853843,2094601,1759242
2010-12-30,12,sms,8824156,5653729,3170427
2010-12-30,13,sms,4806860,9812542,-5005682
2010-12-30,14,sms,1801237,6274692,-4473455
2010-12-30,15,sms,6319710,7596448,-1276738
2010-12-30,16,sms,8246266,5231265,3015001
2010-12-30,17,sms,1171046,1240373,-69327
2010-12-30,18,sms,7968893,334916,7633977
2010-12-30,19,sms,9389004,7242627,2146377
2010-12-30,20,sms,6076943,1648852,4428091
2010-12-30,21,sms,4111699,8066526,-3954827
2010-12-30,22,sms,5813253,8482418,-2669165
2010-12-30,23,sms,2382002,5724155,-3342153
2010-12-30,0,clr,4596393,1302019,3294374
2010-12-30,1,clr,7267298,72428,7194870
2010-12-30,2,clr,4709903,3851163,858740
2010-12-30,3,clr,8808821,7745957,1062864
2010-12-30,4,clr,8592023,4896825,3695198
2010-12-30,5,clr,114358,1611443,-1497085
2010-12-30,6,clr,9353308,7254908,2098400
2010-12-30,7,clr,487547,9692072,-9204525
2010-12-30,8,clr,3922954,5733684,-1810730
2010-12-30,9,clr,5491113,2747354,2743759
2010-12-30,10,clr,3741758,328314,3413444
2010-12-30,11,clr,106742,7488416,-7381674
2010-12-30,12,clr,1552242,4460063,-2907821
2010-12-30,13,clr,6039504,1038542,5000962
2010-12-30,14,clr,3152419,6463729,-3311310
2010-12-30,15,clr,2956683,9099807,-6143124
2010-12-30,16,clr,2490055,2056868,433187
2010-12-30,17,clr,2977986,1953763,1024223
2010-12-30,18,clr,1864852,9455260,-7590408
2010-12-30,19,clr,8997613,9094710,-97097
2010-12-30,20,clr,5416579,446004,4970575
2010-12-30,21,clr,2243501,8246602,-6003101
2010-12-30,22,clr,415139,846660,-431521
2010-12-30,23,clr,9171520,1126563,8044957
